Consumo,TCO,TCS,TIN,TMT,TPR,TRE,TREH,total_general
0,4729,79,37,1,0,14141,41,19028
1,685,7,1,0,1,1737,6,2437
2,363,5,2,0,0,1041,9,1420
3,253,3,1,0,0,867,4,1128
4,244,5,1,0,0,815,2,1067
5,239,1,0,0,0,645,2,887
6,191,8,2,0,0,615,5,821
7,193,3,0,0,0,580,1,777
8,192,0,2,0,0,509,4,707
9,152,3,0,0,0,591,4,750
10,186,4,5,0,0,549,3,747
11,190,3,0,0,0,451,1,645
12,177,2,2,0,0,490,3,674
13,164,3,1,0,0,492,1,661
14,194,6,0,0,0,504,1,705
15,151,2,0,0,0,468,2,623
16,145,1,0,0,0,447,2,595
17,149,1,0,0,0,414,2,566
18,137,3,1,0,0,443,2,586
19,146,5,1,0,0,411,0,563
20,160,2,2,0,0,509,3,676
21,175,3,1,0,0,455,4,638
22,170,2,1,0,0,461,1,635
23,155,2,1,0,0,446,2,606
24,142,1,2,0,0,483,2,630
25,202,3,2,0,0,457,0,664
26,141,4,0,0,0,473,0,618
27,133,2,2,0,0,451,2,590
28,164,0,2,0,0,492,2,660
29,153,2,0,0,0,475,1,631
30,186,4,0,0,0,517,3,710
31,131,2,0,0,0,508,1,642
32,159,1,2,0,0,551,0,713
33,138,6,0,0,0,496,3,643
34,310,5,2,0,0,522,0,839
35,144,3,1,0,0,535,7,690
36,174,4,0,0,0,504,4,686
37,127,6,0,0,0,556,1,690
38,125,1,1,0,0,565,4,696
39,118,2,0,0,0,553,2,675
40,182,5,4,0,0,642,2,835
41,124,3,1,0,0,614,1,743
42,302,4,0,0,0,580,2,888
43,181,0,2,0,0,575,1,759
44,142,1,0,0,0,583,3,729
45,111,2,2,0,0,629,3,747
46,155,4,0,0,0,657,1,817
47,144,1,0,0,0,668,0,813
48,148,3,2,0,0,722,4,879
49,123,5,2,0,0,663,4,797
50,127,4,1,0,0,795,2,929
51,185,2,0,0,0,709,1,897
52,95,3,1,0,0,671,1,771
53,133,5,1,0,0,774,4,917
54,130,3,2,0,0,749,0,884
55,140,2,2,0,0,767,8,919
56,136,3,1,0,0,812,2,954
57,113,1,1,0,0,775,4,894
58,192,0,2,0,0,798,0,992
59,120,4,1,0,0,801,3,929
60,136,5,1,0,0,878,2,1022
61,111,1,0,0,0,869,2,983
62,131,5,0,0,0,878,1,1015
63,133,5,2,0,0,900,2,1042
64,123,4,1,0,0,836,2,966
65,127,4,3,0,0,860,1,995
66,120,6,0,0,0,937,2,1065
67,121,3,1,0,0,885,3,1013
68,145,2,1,0,0,914,0,1062
69,114,7,1,0,0,923,4,1049
70,297,7,0,0,0,1032,3,1339
71,117,4,1,0,0,999,4,1125
72,121,1,2,0,0,973,2,1099
73,164,2,3,0,0,1016,5,1190
74,108,4,2,0,0,1064,1,1179
75,122,0,0,0,0,1014,3,1139
76,111,3,0,0,0,1077,2,1193
77,118,4,1,0,0,1005,2,1130
78,156,1,0,0,0,1043,2,1202
79,119,6,2,0,0,985,0,1112
80,143,6,2,0,0,1085,3,1239
81,119,4,3,0,0,1078,6,1210
82,114,2,2,0,0,1138,1,1257
83,125,1,0,0,0,1131,4,1261
84,128,4,0,0,0,1073,3,1208
85,111,5,2,0,0,1152,7,1277
86,137,3,1,0,0,1185,3,1329
87,103,7,2,0,0,1148,4,1264
88,109,5,1,0,0,1127,5,1247
89,97,5,1,0,0,1210,1,1314
90,112,5,0,0,0,1223,3,1343
91,115,3,2,0,0,1180,3,1303
92,113,5,1,0,0,1285,7,1411
93,93,2,2,0,0,1312,6,1415
94,98,3,1,0,0,1274,4,1380
95,113,1,2,0,0,1308,2,1426
96,103,4,1,0,0,1329,4,1441
97,124,2,1,0,0,1256,6,1389
98,100,4,0,0,0,1266,5,1375
99,113,7,2,0,0,1235,4,1361
100,133,1,1,0,0,1487,2,1624
101,74,2,0,0,0,1318,3,1397
102,100,6,0,0,0,1321,5,1432
103,101,4,0,0,0,1378,3,1486
104,113,8,2,0,0,1335,5,1463
105,109,3,0,0,0,1385,3,1500
106,85,2,1,0,0,1293,4,1385
107,97,2,0,0,0,1362,6,1467
108,113,2,0,0,0,1391,5,1511
109,101,2,1,0,0,1366,5,1475
110,103,1,3,0,0,1542,4,1653
111,100,6,0,0,0,1433,2,1541
112,119,5,0,0,0,1329,4,1457
113,121,1,3,0,0,1430,2,1557
114,98,2,2,0,0,1438,6,1546
115,95,3,2,0,0,1455,5,1560
116,105,4,0,0,0,1483,5,1597
117,99,4,2,0,0,1403,4,1512
118,102,4,1,0,0,1464,6,1577
119,93,5,2,0,0,1458,7,1565
120,137,4,2,0,0,1573,4,1720
121,95,1,1,0,0,1491,5,1593
122,99,2,0,0,0,1464,5,1570
123,80,5,1,0,0,1524,5,1615
124,111,2,0,0,0,1487,6,1606
125,73,3,1,0,0,1428,5,1510
126,71,4,0,0,0,1453,5,1533
127,86,5,2,0,0,1470,6,1569
128,105,6,2,0,0,1558,1,1672
129,93,8,1,0,0,1508,6,1616
130,109,5,0,0,0,1567,11,1692
131,99,2,2,0,0,1524,10,1637
132,86,2,0,0,0,1562,11,1661
133,104,0,1,0,0,1541,6,1652
134,79,4,0,0,0,1516,6,1605
135,94,5,4,0,0,1541,4,1648
136,98,0,2,0,0,1463,6,1569
137,95,4,0,0,0,1611,9,1719
138,100,5,4,0,0,1528,4,1641
139,103,3,0,0,0,1551,7,1664
140,106,3,0,0,0,1664,5,1778
141,86,2,1,0,0,1579,8,1676
142,87,4,1,0,0,1605,5,1702
143,89,5,0,0,0,1595,11,1700
144,84,5,0,0,0,1577,1,1667
145,91,1,2,0,0,1572,9,1675
146,87,6,2,0,0,1635,11,1741
147,99,6,1,0,0,1590,3,1699
148,83,4,0,0,0,1641,7,1735
149,77,3,1,0,0,1574,8,1663
150,88,6,0,0,0,1792,11,1897
151,90,7,1,0,0,1585,6,1689
152,96,3,2,0,0,1562,8,1671
153,92,2,1,0,0,1632,9,1736
154,76,4,0,0,0,1598,7,1685
155,98,1,1,0,0,1699,7,1806
156,65,3,2,0,0,1708,7,1785
157,94,2,1,0,0,1636,14,1747
158,79,1,1,0,0,1606,12,1699
159,76,2,2,0,0,1651,5,1736
160,102,4,1,0,0,1750,7,1864
161,75,5,2,0,0,1564,11,1657
162,93,1,3,0,0,1705,8,1810
163,67,2,1,0,0,1651,10,1731
164,93,4,1,0,0,1660,8,1766
165,74,1,1,0,0,1669,12,1757
166,96,2,0,0,0,1673,7,1778
167,82,4,0,0,0,1695,10,1791
168,95,4,2,0,0,1610,8,1719
169,92,5,0,0,0,1599,9,1705
170,102,1,0,0,0,1763,7,1873
171,84,4,2,0,0,1656,9,1755
172,81,2,0,0,0,1679,16,1778
173,83,3,2,0,0,1689,7,1784
174,83,5,0,0,0,1597,6,1691
175,86,4,3,0,0,1650,10,1753
176,84,3,1,0,0,1611,13,1712
177,66,3,0,0,0,1750,5,1824
178,84,7,2,0,0,1637,14,1744
179,85,3,1,0,0,1646,9,1744
180,92,2,0,0,0,1687,12,1793
181,82,2,1,0,0,1650,14,1749
182,79,2,2,0,0,1647,14,1744
183,63,5,0,0,0,1657,9,1734
184,70,0,0,0,0,1541,11,1622
185,91,2,2,0,0,1632,14,1741
186,78,3,0,0,0,1678,7,1766
187,85,2,2,0,0,1612,9,1710
188,65,3,1,0,0,1584,14,1667
189,73,2,2,0,0,1656,8,1741
190,90,3,2,0,0,1712,5,1812
191,71,1,1,0,0,1584,9,1666
192,64,2,2,0,0,1583,6,1657
193,90,5,1,0,0,1530,9,1635
194,67,6,2,0,0,1591,12,1678
195,68,3,2,0,0,1635,14,1722
196,69,4,0,0,0,1600,10,1683
197,73,3,0,0,0,1667,5,1748
198,76,3,0,0,0,1584,10,1673
199,88,2,0,0,0,1585,10,1685
200,103,5,4,0,0,1699,8,1819
201,74,4,2,0,0,1522,9,1611
202,68,0,1,0,0,1514,9,1592
203,85,1,0,0,0,1507,12,1605
204,72,1,2,0,0,1558,13,1646
205,98,0,1,0,0,1592,5,1696
206,62,4,2,0,0,1490,12,1570
207,77,5,1,0,0,1518,9,1610
208,80,4,0,0,0,1443,15,1542
209,92,1,1,0,0,1546,23,1663
210,74,2,0,0,0,1638,8,1722
211,63,1,2,0,0,1493,11,1570
212,72,2,1,0,0,1589,13,1677
213,73,0,1,0,0,1454,21,1549
214,63,4,0,0,0,1485,9,1561
215,80,4,2,0,0,1451,16,1553
216,75,2,0,0,0,1447,8,1532
217,71,2,3,0,0,1482,11,1569
218,78,4,2,0,0,1425,16,1525
219,91,2,1,0,0,1396,13,1503
220,73,3,1,0,0,1621,9,1707
221,71,4,1,0,0,1449,10,1535
222,67,5,1,0,0,1513,12,1598
223,59,2,1,0,0,1483,13,1558
224,75,5,0,0,0,1483,16,1579
225,72,1,0,0,0,1393,10,1476
226,52,1,1,0,0,1384,14,1452
227,58,3,0,0,0,1389,10,1460
228,68,3,3,0,0,1355,14,1443
229,70,6,1,0,0,1421,14,1512
230,71,4,0,0,0,1448,13,1536
231,60,1,2,0,0,1342,14,1419
232,59,4,2,0,0,1396,14,1475
233,58,0,1,0,0,1367,14,1440
234,87,1,1,0,0,1417,13,1519
235,49,5,1,0,0,1311,18,1384
236,55,6,0,0,0,1324,21,1406
237,78,1,1,0,0,1269,19,1368
238,62,2,0,0,0,1207,10,1281
239,60,9,2,0,0,1246,12,1329
240,72,5,4,0,0,1390,22,1493
241,68,2,1,0,0,1364,20,1455
242,54,3,0,0,0,1320,11,1388
243,73,2,1,0,0,1263,7,1346
244,48,7,2,0,0,1297,11,1365
245,56,7,1,0,0,1239,18,1321
246,61,0,2,0,0,1355,16,1434
247,61,2,0,0,0,1244,21,1328
248,60,0,3,0,0,1218,13,1294
249,62,1,0,0,0,1190,14,1267
250,89,3,0,0,0,1250,19,1361
251,50,8,0,0,0,1158,20,1236
252,38,4,1,0,0,1169,15,1227
253,68,1,0,0,0,1166,19,1254
254,66,5,0,0,0,1168,10,1249
255,64,1,0,0,0,1159,10,1234
256,63,1,0,0,0,1179,10,1253
257,56,4,2,0,0,1134,12,1208
258,66,2,0,0,0,1160,19,1247
259,49,4,0,0,0,1146,15,1214
260,75,2,2,0,0,1276,9,1364
261,48,3,2,0,0,1117,16,1186
262,47,6,0,0,0,1078,19,1150
263,58,3,0,0,0,1073,11,1145
264,54,2,0,0,0,1078,10,1144
265,52,1,1,0,0,1073,15,1142
266,49,2,0,0,0,1135,12,1198
267,60,2,0,0,0,1068,19,1149
268,53,2,2,0,0,1058,18,1133
269,57,2,2,0,0,1070,16,1147
270,53,4,1,0,0,1090,20,1168
271,43,2,0,0,0,1068,18,1131
272,44,3,0,0,0,1053,9,1109
273,73,2,0,0,0,1007,16,1098
274,43,1,0,0,0,1053,9,1106
275,59,3,0,0,0,992,8,1062
276,85,1,2,0,0,1029,6,1123
277,69,4,1,0,0,989,24,1087
278,52,1,0,0,0,1028,16,1097
279,53,0,1,0,0,1023,12,1089
280,69,6,0,0,0,1072,13,1160
281,54,0,1,0,0,1027,17,1099
282,59,2,0,0,0,980,13,1054
283,56,2,1,0,0,990,14,1063
284,51,3,0,0,0,931,16,1001
285,57,1,1,0,0,933,14,1006
286,68,2,1,0,0,1013,15,1099
287,72,5,2,0,0,964,8,1051
288,45,3,0,0,0,922,16,986
289,58,5,0,0,0,957,11,1031
290,68,2,0,0,0,1029,14,1113
291,45,2,0,0,0,910,9,966
292,58,6,2,0,0,902,11,979
293,56,2,2,0,0,949,18,1027
294,55,3,0,0,0,937,13,1008
295,41,5,2,0,0,904,11,963
296,40,5,1,0,0,931,11,988
297,58,1,1,0,0,844,20,924
298,61,3,0,0,0,841,15,920
299,57,2,0,0,0,859,17,935
300,74,0,2,0,0,941,10,1027
301,52,6,2,0,0,827,6,893
302,44,1,0,0,0,841,13,899
303,48,3,1,0,0,806,12,870
304,51,3,2,0,0,837,10,903
305,44,3,1,0,0,824,22,894
306,60,1,1,0,0,837,10,909
307,40,2,1,0,0,823,11,877
308,58,5,1,0,0,767,14,845
309,47,6,0,0,0,798,14,865
310,67,3,2,0,0,830,14,916
311,54,4,0,0,0,778,9,845
312,58,1,1,0,0,798,16,874
313,48,3,0,0,0,765,15,831
314,56,3,0,0,0,769,19,847
315,59,1,1,0,0,761,18,840
316,54,3,0,0,0,765,17,839
317,47,1,2,0,0,733,10,793
318,53,3,0,0,0,731,12,799
319,43,4,2,0,0,716,9,774
320,60,2,2,0,0,753,18,835
321,60,1,0,0,0,662,14,737
322,52,2,1,0,0,695,20,770
323,55,2,0,0,0,694,15,766
324,52,0,1,0,0,709,15,777
325,51,3,0,0,0,702,14,770
326,51,1,0,0,0,637,12,701
327,55,2,2,0,0,656,12,727
328,54,3,0,0,0,696,11,764
329,54,3,3,0,0,665,16,741
330,49,2,0,0,0,687,13,751
331,45,5,2,0,0,697,5,754
332,55,5,0,0,0,677,10,747
333,57,3,0,0,0,639,20,719
334,45,3,2,0,0,635,13,698
335,45,3,1,0,0,655,16,720
336,44,2,1,0,0,661,13,721
337,53,1,0,0,0,613,12,679
338,43,1,0,0,0,602,9,655
339,39,1,1,0,0,656,17,714
340,45,0,0,0,0,633,14,692
341,58,2,0,0,0,581,11,652
342,92,6,0,0,0,600,11,709
343,48,3,0,0,0,574,12,637
344,41,3,1,0,0,599,13,657
345,54,1,0,0,0,538,14,607
346,55,1,0,0,0,596,18,670
347,43,2,1,0,0,564,13,623
348,51,9,0,0,0,528,13,601
349,41,2,0,0,0,586,16,645
350,48,2,0,0,0,653,12,715
351,54,5,1,0,0,593,19,672
352,44,3,4,0,0,527,11,589
353,51,1,0,0,0,514,7,573
354,36,3,0,0,0,568,15,622
355,35,2,0,0,0,503,18,558
356,48,6,0,0,0,532,14,600
357,38,6,0,0,0,531,16,591
358,43,4,1,0,0,541,7,596
359,57,2,0,0,0,548,15,622
360,66,4,2,0,0,521,11,604
361,42,3,0,0,0,517,13,575
362,45,4,0,0,0,537,17,603
363,46,1,0,0,0,531,9,587
364,43,2,0,0,0,510,11,566
365,50,1,2,0,0,493,15,561
366,41,1,1,0,0,471,11,525
367,44,3,0,0,0,471,8,526
368,46,2,1,0,0,461,12,522
369,41,0,1,0,0,486,16,544
370,47,3,0,0,0,540,6,596
371,50,4,1,0,0,439,9,503
372,52,3,1,0,0,485,15,556
373,44,3,1,0,0,514,13,575
374,41,3,0,0,0,487,14,545
375,43,5,3,0,0,435,14,500
376,39,1,0,0,0,473,23,536
377,36,3,0,0,0,418,11,468
378,47,3,0,0,0,424,13,487
379,51,4,2,0,0,453,17,527
380,56,3,2,0,0,475,14,550
381,51,0,0,0,0,405,9,465
382,33,5,1,0,0,409,8,456
383,40,4,0,0,0,452,9,505
384,32,2,0,0,0,404,18,456
385,45,3,2,0,0,451,18,519
386,32,0,0,0,0,416,13,461
387,46,4,0,0,0,443,13,506
388,35,2,0,0,0,411,13,461
389,46,3,0,0,0,397,13,459
390,53,4,0,0,0,431,17,505
391,22,6,1,0,0,432,16,477
392,32,0,1,0,0,414,18,465
393,40,1,1,0,0,358,17,417
394,45,1,1,0,0,370,11,428
395,39,0,0,0,0,396,15,450
396,36,2,1,0,0,381,16,436
397,42,3,1,0,0,412,16,474
398,41,1,0,0,0,366,18,426
399,52,3,0,0,0,369,8,432
400,66,4,0,0,0,422,10,502
401,49,1,2,0,0,382,13,447
402,39,4,1,0,0,341,18,403
403,35,0,1,0,0,356,14,406
404,35,3,1,0,0,337,12,388
405,43,3,2,0,0,343,10,401
406,43,2,2,0,0,337,16,400
407,48,4,3,0,0,363,9,427
408,31,2,0,0,0,353,8,394
409,38,3,1,0,0,344,15,401
410,47,1,1,0,0,332,14,395
411,40,2,1,0,0,346,14,403
412,38,4,0,0,0,335,10,387
413,41,4,1,0,0,352,14,412
414,36,1,0,0,0,317,5,359
415,26,0,0,0,0,323,11,360
416,29,1,1,0,0,336,13,380
417,48,3,0,0,0,290,14,355
418,39,3,1,0,0,313,14,370
419,33,0,0,0,0,320,6,359
420,48,0,1,0,0,366,13,428
421,31,7,0,0,0,312,14,364
422,38,0,0,0,0,339,10,387
423,36,2,1,0,0,314,14,367
424,45,1,1,0,0,303,19,369
425,30,2,0,0,0,310,9,351
426,48,5,2,0,0,287,12,354
427,32,3,2,0,0,274,7,318
428,26,4,1,0,0,294,17,342
429,25,2,1,0,0,281,12,321
430,38,5,1,0,0,310,10,364
431,42,2,0,0,0,267,7,318
432,46,2,1,0,0,250,13,312
433,31,1,0,0,0,303,10,345
434,28,3,2,0,0,313,11,357
435,41,4,2,0,0,262,13,322
436,41,1,1,0,0,240,7,290
437,39,2,0,0,0,285,13,339
438,56,4,0,0,0,253,15,328
439,28,4,1,0,0,278,9,320
440,36,1,4,0,0,308,6,355
441,28,1,0,0,0,260,8,297
442,34,2,0,0,0,249,19,304
443,29,6,1,0,0,247,8,291
444,26,1,1,0,0,250,16,294
445,29,4,1,0,0,237,9,280
446,36,2,1,0,0,220,9,268
447,26,3,0,0,0,242,9,280
448,32,3,1,0,0,235,9,280
449,38,0,1,0,0,234,6,279
450,42,1,0,0,0,252,11,306
451,28,2,0,0,0,234,17,281
452,36,2,1,0,0,233,11,283
453,31,1,0,0,0,229,15,276
454,30,3,1,0,0,244,15,293
455,38,2,2,0,0,225,8,275
456,39,3,1,0,0,233,10,286
457,32,3,0,0,0,254,15,304
458,31,3,0,0,0,236,9,279
459,42,1,1,0,0,253,7,304
460,33,2,0,0,0,248,7,290
461,30,1,0,0,0,221,5,257
462,38,0,0,0,0,236,14,288
463,31,4,0,0,0,216,9,260
464,35,2,2,0,0,193,6,238
465,36,1,0,0,0,193,14,244
466,34,1,0,0,0,200,11,246
467,37,0,1,0,0,234,8,280
468,41,2,1,0,0,232,9,285
469,39,1,0,0,0,209,8,257
470,36,1,0,0,0,195,13,245
471,27,5,0,0,0,204,6,242
472,24,0,1,0,0,210,11,246
473,36,3,1,0,0,212,9,261
474,30,0,0,0,0,183,10,223
475,31,1,1,0,0,197,7,237
476,33,2,0,0,0,209,14,258
477,31,3,2,0,0,183,4,223
478,38,3,0,0,0,204,11,256
479,37,1,0,0,0,173,6,217
480,46,0,1,0,0,195,11,253
481,33,2,2,0,0,214,10,261
482,31,3,0,0,0,181,5,220
483,27,3,0,0,0,157,8,195
484,32,1,1,0,0,170,9,213
485,32,2,0,0,0,187,8,229
486,31,1,1,0,0,187,9,229
487,27,2,0,0,0,178,12,219
488,38,1,1,0,0,191,13,244
489,34,1,1,0,0,190,4,230
490,36,3,0,0,0,203,10,252
491,37,1,0,0,0,195,8,241
492,32,4,1,0,0,178,6,221
493,34,3,0,0,0,180,11,228
494,24,2,0,0,0,171,10,207
495,27,2,1,0,0,164,10,204
496,16,0,2,0,0,167,13,198
497,35,3,0,0,0,167,9,214
498,24,0,0,0,0,168,7,199
499,28,3,1,0,0,164,9,205
500,50,2,1,0,0,178,6,237
501,26,2,0,0,0,168,6,202
502,38,1,1,0,0,151,4,195
503,39,0,0,0,0,140,12,191
504,36,4,0,0,0,167,9,216
505,35,3,0,0,0,160,8,206
506,31,1,0,0,0,162,9,203
507,34,1,1,0,0,168,10,214
508,21,1,2,0,0,166,6,196
509,30,0,0,0,0,154,6,190
510,29,3,0,0,0,178,10,220
511,19,3,0,0,0,130,6,158
512,33,2,0,0,0,155,7,197
513,32,0,2,0,0,138,9,181
514,37,0,0,0,0,135,9,181
515,32,0,0,0,0,135,4,171
516,35,1,0,0,0,174,9,219
517,29,4,2,0,0,142,7,184
518,33,1,2,0,0,141,9,186
519,40,2,0,0,0,153,10,205
520,33,1,2,0,0,164,5,205
521,34,1,0,0,0,133,12,180
522,32,1,1,0,0,127,9,170
523,22,2,0,0,0,158,9,191
524,28,3,1,0,0,133,9,174
525,31,2,0,0,0,155,8,196
526,33,0,1,0,0,126,9,169
527,23,1,1,0,0,136,9,170
528,28,2,0,0,0,129,16,175
529,27,1,0,0,0,137,6,171
530,41,2,1,0,0,163,8,215
531,27,0,0,0,0,129,6,162
532,31,2,1,0,0,129,4,167
533,28,0,3,0,0,149,8,188
534,31,0,0,0,0,113,4,148
535,30,1,0,0,0,126,8,165
536,30,2,0,0,0,121,10,163
537,35,1,1,0,0,115,3,155
538,37,2,0,0,0,151,5,195
539,23,1,1,0,0,114,6,145
540,38,0,0,0,0,126,10,174
541,27,2,0,0,0,133,5,167
542,21,0,1,0,0,142,6,170
543,27,1,0,0,0,106,8,142
544,32,1,1,0,0,112,6,152
545,28,5,0,0,0,103,3,139
546,42,4,1,0,0,123,10,180
547,29,4,0,0,0,135,4,172
548,30,0,1,0,0,112,4,147
549,30,0,0,0,0,122,3,155
550,32,3,1,0,0,127,2,165
551,31,1,0,0,0,113,10,155
552,32,1,2,0,0,98,5,138
553,36,2,0,0,0,117,3,158
554,36,0,1,0,0,120,11,168
555,29,0,0,0,0,143,5,177
556,36,0,1,0,0,112,6,155
557,30,3,1,0,0,119,3,156
558,33,0,0,0,0,102,6,141
559,32,4,0,0,0,105,0,141
560,32,2,0,0,0,111,6,151
561,28,2,1,0,0,105,6,142
562,30,2,0,0,0,105,8,145
563,27,0,1,0,0,108,3,139
564,40,1,2,0,0,98,2,143
565,28,3,0,0,0,124,3,158
566,35,1,2,0,0,103,3,144
567,25,0,1,0,0,103,8,137
568,25,2,0,0,0,109,6,142
569,32,3,1,0,0,86,8,130
570,32,2,0,0,0,119,3,156
571,38,0,0,0,0,97,6,141
572,22,1,0,0,0,89,6,118
573,25,0,0,0,0,98,5,128
574,37,1,0,0,0,105,7,150
575,28,2,1,0,0,105,4,140
576,23,1,0,0,0,95,3,122
577,31,3,0,0,0,93,2,129
578,30,2,0,0,0,95,4,131
579,23,3,0,0,0,100,4,130
580,22,0,2,0,0,83,3,110
581,34,0,0,0,0,82,5,121
582,25,0,0,0,0,95,7,127
583,29,3,0,0,0,113,8,153
584,40,1,1,0,0,81,6,129
585,32,1,0,0,0,80,14,127
586,25,0,0,0,0,106,4,135
587,25,3,0,0,0,89,7,124
588,19,1,0,0,0,94,3,117
589,31,0,0,0,0,97,5,133
590,25,1,0,0,0,104,1,131
591,25,1,1,0,0,99,8,134
592,18,2,1,0,0,83,5,109
593,25,1,2,0,0,95,2,125
594,33,5,1,0,0,84,4,127
595,20,3,2,0,0,98,3,126
596,20,2,0,0,0,88,9,119
597,23,2,1,0,0,76,3,105
598,33,0,0,0,0,94,7,134
599,29,3,1,0,0,77,10,120
600,34,0,2,0,0,84,6,126
601,20,2,0,0,0,80,11,113
602,32,0,0,0,0,85,4,121
603,27,0,2,0,0,74,7,110
604,28,4,0,0,0,81,5,118
605,25,1,0,0,0,83,5,114
606,30,3,0,0,0,65,3,101
607,21,2,0,0,0,67,5,95
608,30,0,0,0,0,83,2,115
609,18,0,1,0,0,65,4,88
610,22,4,1,0,0,82,2,111
611,33,1,1,0,0,78,2,115
612,22,0,0,0,0,69,6,97
613,21,3,1,0,0,82,1,108
614,21,3,1,0,0,84,4,113
615,27,1,1,0,0,75,1,105
616,23,2,0,0,0,74,4,103
617,24,1,0,0,0,73,4,102
618,18,1,1,0,0,68,5,93
619,26,2,0,0,0,78,6,112
620,23,1,0,0,0,80,4,108
621,18,2,1,0,0,77,8,106
622,23,1,0,0,0,73,6,103
623,15,2,0,0,0,74,3,94
624,25,0,2,0,0,70,4,101
625,29,1,0,0,0,74,5,109
626,33,0,2,0,0,54,1,90
627,26,1,1,0,0,75,4,107
628,24,0,0,0,0,60,6,90
629,27,1,0,0,0,67,6,101
630,26,3,1,0,0,73,8,111
631,25,1,2,0,0,91,4,123
632,32,0,0,0,0,79,7,118
633,19,0,0,0,0,72,4,95
634,18,3,2,0,0,73,5,101
635,21,1,1,0,0,53,3,79
636,18,2,0,0,0,62,1,83
637,35,3,0,0,0,68,2,108
638,25,0,1,0,0,70,3,99
639,17,0,0,0,0,64,3,84
640,30,1,3,0,0,63,7,104
641,20,0,0,0,0,51,7,78
642,30,3,0,0,0,69,6,108
643,19,2,0,0,0,65,5,91
644,30,0,1,0,0,54,6,91
645,21,0,2,0,0,58,4,85
646,27,1,0,0,0,65,2,95
647,20,1,0,0,0,64,4,89
648,25,0,0,0,0,69,3,97
649,33,1,1,0,0,56,5,96
650,29,4,2,0,0,66,3,104
651,25,2,0,0,0,58,2,87
652,29,2,0,0,0,59,5,95
653,23,0,0,0,0,74,2,99
654,28,1,1,0,0,68,5,103
655,20,0,0,0,0,70,4,94
656,18,1,2,0,0,47,3,71
657,28,1,0,0,0,59,5,93
658,14,5,0,0,0,59,7,85
659,23,0,0,0,0,45,2,70
660,29,0,2,0,0,56,7,94
661,12,1,1,0,0,64,3,81
662,22,0,2,0,0,66,1,91
663,24,0,2,0,0,55,1,82
664,29,2,2,0,0,53,5,91
665,24,2,0,0,0,47,5,78
666,15,1,0,0,0,57,3,76
667,27,0,0,0,0,56,3,86
668,25,3,0,0,0,57,6,91
669,21,2,0,0,0,64,5,92
670,22,1,0,0,0,60,5,88
671,18,0,0,0,0,55,3,76
672,25,0,0,0,0,54,2,81
673,25,0,0,0,0,42,2,69
674,13,0,0,0,0,70,0,83
675,19,1,2,0,0,45,3,70
676,31,1,1,0,0,64,6,103
677,20,1,0,0,0,41,1,63
678,21,0,0,0,0,41,6,68
679,17,0,0,0,0,46,2,65
680,27,2,1,0,0,57,4,91
681,21,2,1,0,0,41,2,67
682,19,1,1,0,0,47,5,73
683,22,1,0,0,0,58,2,83
684,17,0,0,0,0,46,2,65
685,23,1,0,0,0,58,4,86
686,19,0,1,0,0,49,2,71
687,15,1,1,0,0,45,5,67
688,17,2,0,0,0,59,4,82
689,29,0,0,0,0,48,2,79
690,18,1,1,0,0,59,4,83
691,24,2,0,0,0,55,3,84
692,18,0,0,0,0,47,3,68
693,29,0,0,0,0,40,1,70
694,24,1,0,0,0,49,2,76
695,21,0,0,0,0,55,3,79
696,22,0,0,0,0,41,3,66
697,23,1,0,0,0,45,4,73
698,26,1,0,0,0,45,0,72
699,27,0,1,0,0,43,7,78
700,28,1,0,0,0,39,2,70
701,14,0,0,0,0,55,3,72
702,19,1,2,0,0,47,3,72
703,21,3,1,0,0,47,3,75
704,18,0,0,0,0,43,2,63
705,20,2,0,0,0,43,1,66
706,29,0,0,0,0,50,1,80
707,21,0,0,0,0,45,3,69
708,12,0,1,0,0,46,3,62
709,16,2,0,0,0,44,4,66
710,20,2,0,0,0,39,2,63
711,21,1,1,0,0,30,3,56
712,20,3,0,0,0,46,4,73
713,14,0,0,0,0,32,3,49
714,18,0,0,0,0,36,4,58
715,23,1,0,0,0,33,6,63
716,28,2,0,0,0,50,0,80
717,19,2,0,0,0,34,4,59
718,19,2,0,0,0,35,0,56
719,21,0,0,0,0,52,4,77
720,31,2,2,0,0,45,2,82
721,21,0,0,0,0,47,2,70
722,22,0,0,0,0,37,4,63
723,22,0,2,0,0,34,4,62
724,16,1,0,0,0,44,3,64
725,15,1,0,0,0,37,3,56
726,18,2,0,0,0,37,0,57
727,17,0,0,0,0,36,5,58
728,17,1,2,0,0,42,6,68
729,12,1,2,0,0,32,2,49
730,27,2,0,0,0,37,4,70
731,21,0,2,0,0,35,7,65
732,14,0,0,0,0,34,2,50
733,18,1,0,0,0,30,1,50
734,17,2,1,0,0,44,3,67
735,18,0,0,0,0,39,7,64
736,19,1,2,0,0,47,2,71
737,18,3,0,0,0,45,5,71
738,12,1,0,0,0,41,7,61
739,16,0,0,0,0,34,4,54
740,17,0,0,0,0,53,2,72
741,10,0,0,0,0,35,2,47
742,21,1,0,0,0,41,4,67
743,14,0,0,0,0,26,3,43
744,15,1,1,0,0,33,2,52
745,23,0,0,0,0,45,3,71
746,18,1,1,0,0,35,2,57
747,19,1,0,0,0,33,3,56
748,32,0,1,0,0,38,2,73
749,25,0,1,0,0,38,4,68
750,23,0,1,0,0,47,0,71
751,27,1,0,0,0,41,2,71
752,15,0,0,0,0,41,3,59
753,14,1,0,0,0,39,7,61
754,27,0,0,0,0,33,0,60
755,20,1,1,0,0,29,2,53
756,75,2,1,0,0,32,3,113
757,18,1,0,0,0,34,0,53
758,13,0,0,0,0,34,3,50
759,19,1,0,0,0,20,1,41
760,19,3,0,0,0,21,2,45
761,10,2,1,0,0,33,5,51
762,14,0,0,0,0,27,3,44
763,20,0,0,0,0,26,4,50
764,15,0,0,0,0,33,2,50
765,20,0,1,0,0,38,4,63
766,9,1,1,0,0,25,3,39
767,25,0,0,0,0,27,5,57
768,16,1,1,0,0,35,3,56
769,16,0,0,0,0,33,3,52
770,11,0,1,0,0,36,1,49
771,20,1,0,0,0,33,1,55
772,16,1,0,0,0,25,1,43
773,18,1,1,0,0,31,3,54
774,18,1,0,0,0,28,1,48
775,12,1,0,0,1,36,1,51
776,17,1,0,0,0,29,3,50
777,23,1,2,0,0,32,1,59
778,16,4,0,0,0,32,2,54
779,25,0,0,0,0,42,1,68
780,18,3,0,0,0,30,2,53
781,19,0,2,0,0,32,5,58
782,16,0,3,0,0,24,1,44
783,22,0,0,0,0,26,3,51
784,22,2,0,0,0,31,3,58
785,20,0,0,0,0,30,1,51
786,18,0,0,0,0,27,4,49
787,15,1,1,0,0,22,1,40
788,18,0,0,0,0,30,2,50
789,17,1,1,0,0,20,4,43
790,19,0,1,0,0,30,2,52
791,12,0,0,0,0,29,2,43
792,15,0,1,0,0,22,1,39
793,16,0,0,0,0,28,1,45
794,11,2,0,0,0,32,2,47
795,14,0,2,0,0,26,6,48
796,16,0,0,0,0,28,1,45
797,22,1,1,0,0,25,3,52
798,18,0,1,0,0,30,2,51
799,15,0,1,0,0,27,3,46
800,29,1,0,0,0,33,2,65
801,18,1,0,0,0,24,0,43
802,15,1,0,0,0,29,2,47
803,27,2,0,0,0,24,0,53
804,18,0,0,0,0,21,3,42
805,18,0,1,0,0,36,2,57
806,9,3,0,0,0,23,1,36
807,16,1,0,0,0,23,2,42
808,24,0,0,0,0,31,2,57
809,21,1,1,0,0,24,1,48
810,17,0,0,0,0,27,1,45
811,14,0,1,0,0,21,1,37
812,16,1,0,0,0,29,2,48
813,13,1,0,0,0,30,3,47
814,17,0,1,0,0,21,2,41
815,18,2,0,0,0,26,0,46
816,15,0,1,0,0,30,2,48
817,12,0,0,0,0,19,1,32
818,18,2,0,0,0,22,1,43
819,11,0,1,0,0,23,1,36
820,16,0,1,0,0,24,1,42
821,22,1,0,0,0,29,2,54
822,14,0,2,0,0,20,2,38
823,27,2,1,0,0,23,2,55
824,12,0,0,0,0,24,0,36
825,13,0,1,0,0,22,2,38
826,18,0,1,0,0,31,1,51
827,20,0,0,0,0,20,1,41
828,16,1,0,0,0,20,2,39
829,10,1,0,0,0,30,2,43
830,18,1,0,0,0,17,4,40
831,10,0,1,0,0,22,5,38
832,12,0,0,0,0,25,1,38
833,13,0,0,0,0,29,3,45
834,9,0,0,0,0,33,1,43
835,16,2,0,0,0,23,1,42
836,18,1,2,0,0,26,3,50
837,14,1,0,0,0,33,0,48
838,17,0,1,0,0,16,4,38
839,11,1,0,0,0,25,4,41
840,22,1,0,0,0,26,2,51
841,19,2,0,0,0,24,3,48
842,16,0,0,0,0,21,2,39
843,18,0,0,0,0,19,2,39
844,19,0,2,0,0,24,1,46
845,12,2,1,0,0,22,0,37
846,16,0,2,0,0,26,3,47
847,20,1,0,0,0,16,0,37
848,11,1,1,0,0,20,4,37
849,16,1,0,0,0,17,1,35
850,16,1,1,0,0,24,3,45
851,10,2,0,0,0,18,1,31
852,18,1,0,0,0,31,0,50
853,13,1,0,0,0,16,0,30
854,16,0,0,0,0,18,2,36
855,10,1,0,0,0,17,4,32
856,9,0,0,0,0,18,1,28
857,24,0,1,0,0,16,3,44
858,16,0,0,0,0,21,2,39
859,15,2,0,0,0,17,0,34
860,16,0,1,0,0,18,0,35
861,8,0,0,0,0,19,0,27
862,17,0,0,0,0,18,1,36
863,13,0,0,0,0,20,3,36
864,15,1,0,0,0,17,1,34
865,13,0,0,0,0,22,1,36
866,19,0,0,0,0,27,1,47
867,14,0,1,0,0,15,1,31
868,17,2,1,0,0,18,0,38
869,10,1,1,0,0,29,2,43
870,17,2,0,0,0,23,4,46
871,11,1,0,0,0,22,0,34
872,16,0,1,0,0,25,3,45
873,25,0,0,0,0,19,2,46
874,12,0,0,0,0,18,0,30
875,16,1,2,0,0,17,0,36
876,17,0,0,0,0,15,1,33
877,18,1,1,0,0,24,0,44
878,19,0,1,0,0,28,1,49
879,16,2,0,0,0,22,4,44
880,24,0,1,0,0,19,2,46
881,10,1,0,0,0,19,1,31
882,16,0,0,0,0,23,2,41
883,13,0,0,0,0,19,1,33
884,15,0,1,0,0,20,0,36
885,13,0,1,0,0,13,2,29
886,15,0,0,0,0,17,2,34
887,12,0,0,0,0,21,0,33
888,14,2,0,0,0,19,1,36
889,16,2,0,0,0,17,0,35
890,12,0,0,0,0,23,1,36
891,13,0,2,0,0,22,0,37
892,14,2,0,0,0,19,0,35
893,6,0,0,0,0,21,1,28
894,12,1,0,0,0,18,2,33
895,16,1,2,0,0,17,0,36
896,13,0,1,0,0,17,1,32
897,12,1,0,0,0,19,0,32
898,17,2,0,0,0,15,1,35
899,18,0,1,0,0,16,0,35
900,19,1,2,0,0,23,1,46
901,16,0,0,0,0,14,1,31
902,15,0,0,0,0,10,3,28
903,18,1,0,0,0,11,2,32
904,14,0,1,0,0,14,1,30
905,12,0,0,0,0,15,2,29
906,13,0,1,0,0,16,1,31
907,13,1,0,0,0,15,2,31
908,14,1,0,0,0,18,3,36
909,14,1,1,0,0,15,2,33
910,17,2,0,0,0,15,1,35
911,18,1,1,0,0,11,1,32
912,11,0,1,0,0,17,1,30
913,17,1,0,0,0,17,4,39
914,21,0,0,0,0,17,3,41
915,10,1,0,0,0,15,5,31
916,14,1,1,0,0,15,2,33
917,16,0,0,0,0,13,2,31
918,15,0,1,0,0,11,1,28
919,11,2,0,0,0,12,2,27
920,15,2,3,0,0,6,1,27
921,15,0,0,0,0,16,2,33
922,11,1,1,0,0,15,2,30
923,14,1,1,0,0,17,2,35
924,19,0,0,0,0,12,3,34
925,12,0,0,0,0,17,0,29
926,16,0,2,0,0,13,0,31
927,12,1,0,0,0,18,2,33
928,11,0,1,0,0,19,3,34
929,15,0,0,0,0,7,0,22
930,16,1,0,0,0,13,2,32
931,6,0,0,0,0,18,0,24
932,10,0,0,0,0,13,0,23
933,12,0,2,0,0,10,1,25
934,15,0,0,0,0,18,1,34
935,15,2,0,0,0,10,1,28
936,21,1,0,0,0,18,1,41
937,13,0,0,0,0,7,3,23
938,12,1,0,0,0,17,2,32
939,15,0,0,0,0,14,0,29
940,10,1,1,0,0,20,0,32
941,13,0,0,0,0,15,1,29
942,8,0,0,0,0,20,0,28
943,14,0,0,0,0,15,2,31
944,14,1,0,0,0,15,1,31
945,18,0,0,0,0,14,1,33
946,13,1,0,0,0,12,1,27
947,8,1,1,0,0,10,0,20
948,13,1,0,0,0,26,3,43
949,24,0,0,0,0,10,1,35
950,57,0,0,0,0,18,1,76
951,14,1,2,0,0,9,2,28
952,6,0,2,0,0,10,0,18
953,18,0,1,0,0,11,2,32
954,16,1,1,0,0,9,1,28
955,18,0,0,0,0,14,3,35
956,10,1,0,0,0,16,3,30
957,17,1,1,0,0,13,3,35
958,1,1,1,0,0,14,2,19
959,10,0,4,0,0,10,1,25
960,17,3,3,0,0,14,0,37
961,20,0,0,0,0,8,1,29
962,12,1,0,0,0,11,1,25
963,10,0,0,0,0,10,0,20
964,12,0,0,0,0,14,1,27
965,19,0,0,0,0,18,2,39
966,10,0,0,0,0,14,1,25
967,12,1,0,0,0,12,1,26
968,16,2,1,0,0,16,3,38
969,9,1,1,0,0,13,1,25
970,8,0,0,0,0,20,1,29
971,7,1,0,0,0,20,2,30
972,11,0,0,0,0,9,5,25
973,17,2,0,0,0,8,0,27
974,7,1,1,0,0,8,0,17
975,9,0,0,0,0,11,0,20
976,12,0,2,0,0,11,0,25
977,16,4,1,0,0,17,1,39
978,12,1,0,0,0,25,2,40
979,18,1,1,0,0,8,1,29
980,15,0,0,0,0,22,1,38
981,9,0,0,0,0,14,0,23
982,14,2,0,0,0,11,1,28
983,14,1,1,0,0,17,1,34
984,11,3,0,0,0,12,2,28
985,12,0,0,0,0,12,0,24
986,11,1,1,0,0,11,2,26
987,21,0,0,0,0,19,0,40
988,13,0,0,0,0,7,2,22
989,17,0,1,0,0,16,1,35
990,14,1,0,0,0,10,0,25
991,19,1,0,0,0,10,3,33
992,14,0,0,0,0,17,2,33
993,8,2,0,0,0,12,2,24
994,13,1,0,0,0,18,2,34
995,13,1,0,0,0,9,2,25
996,15,1,1,0,0,8,1,26
997,11,2,0,0,0,7,0,20
998,19,0,0,0,0,10,2,31
999,15,1,0,0,0,17,0,33
1000,24,0,1,0,0,23,3,51
1001,15,0,0,0,0,8,1,24
1002,8,0,1,0,0,6,0,15
1003,11,0,1,0,0,12,1,25
1004,11,0,1,0,0,13,3,28
1005,20,2,0,0,0,16,2,40
1006,11,0,0,0,0,5,0,16
1007,7,1,1,0,0,12,2,23
1008,5,2,1,0,0,12,0,20
1009,10,1,0,0,0,7,1,19
1010,12,1,0,0,0,10,0,23
1011,6,0,0,0,0,9,0,15
1012,11,0,1,0,0,9,2,23
1013,17,2,2,0,0,11,1,33
1014,8,0,0,0,0,12,1,21
1015,19,0,0,0,0,14,0,33
1016,13,0,1,0,0,14,4,32
1017,10,0,0,0,0,15,0,25
1018,9,1,0,0,0,11,0,21
1019,9,0,2,0,0,18,4,33
1020,15,0,1,0,0,9,1,26
1021,9,1,1,0,0,9,3,23
1022,19,0,0,0,0,5,1,25
1023,6,0,0,0,0,10,1,17
1024,8,0,0,0,0,8,0,16
1025,11,1,0,0,0,13,0,25
1026,9,0,0,0,0,12,1,22
1027,12,0,1,0,0,9,0,22
1028,12,1,0,0,0,5,2,20
1029,9,1,1,0,0,8,0,19
1030,13,0,0,0,0,8,0,21
1031,14,1,0,0,0,12,0,27
1032,15,0,0,0,0,7,2,24
1033,17,1,1,0,0,7,2,28
1034,14,0,0,0,0,9,1,24
1035,13,1,0,0,0,11,0,25
1036,16,0,1,0,0,6,1,24
1037,14,0,0,0,0,20,1,35
1038,7,0,0,0,0,11,0,18
1039,18,0,0,0,0,11,1,30
1040,25,2,1,0,0,12,1,41
1041,10,0,0,0,0,5,2,17
1042,11,0,1,0,0,12,2,26
1043,10,0,0,0,0,7,1,18
1044,10,1,0,0,0,10,2,23
1045,10,1,0,0,0,6,2,19
1046,5,0,0,0,0,12,0,17
1047,9,1,0,0,0,9,0,19
1048,6,1,2,0,0,15,0,24
1049,7,1,0,0,0,4,1,13
1050,11,2,0,0,0,9,1,23
1051,6,0,0,0,0,15,0,21
1052,7,0,0,0,0,3,0,10
1053,8,1,0,0,0,7,0,16
1054,10,1,0,0,0,18,1,30
1055,10,1,1,0,0,7,0,19
1056,13,1,0,0,0,6,0,20
1057,19,0,0,0,0,9,0,28
1058,13,1,0,0,0,6,0,20
1059,8,1,0,0,0,5,1,15
1060,7,0,0,0,0,11,0,18
1061,9,2,0,0,0,9,2,22
1062,9,1,0,0,0,7,0,17
1063,17,1,0,0,0,7,0,25
1064,11,0,0,0,0,6,1,18
1065,5,1,0,0,0,12,1,19
1066,16,1,0,0,0,11,1,29
1067,14,1,0,0,0,7,0,22
1068,14,1,0,0,0,13,2,30
1069,6,0,0,0,0,5,2,13
1070,10,0,0,0,0,5,0,15
1071,6,0,0,0,0,8,1,15
1072,13,0,1,0,0,12,0,26
1073,6,0,0,0,0,12,1,19
1074,10,2,0,0,0,15,0,27
1075,12,1,0,0,0,5,0,18
1076,18,0,0,0,0,7,2,27
1077,12,0,0,0,0,9,0,21
1078,14,0,0,0,0,2,0,16
1079,12,0,0,0,0,8,0,20
1080,20,2,1,0,0,6,0,29
1081,7,2,0,0,0,10,1,20
1082,7,0,0,0,0,2,2,11
1083,15,1,0,0,0,9,0,25
1084,18,2,0,0,0,5,0,25
1085,10,0,1,0,0,6,0,17
1086,13,1,1,0,0,9,0,24
1087,13,2,0,0,0,7,0,22
1088,17,0,0,0,0,6,1,24
1089,10,0,2,0,0,12,2,26
1090,13,0,0,0,0,8,0,21
1091,15,0,0,0,0,10,0,25
1092,8,0,0,0,0,8,0,16
1093,11,1,0,0,0,6,2,20
1094,12,1,1,0,0,13,1,28
1095,12,0,0,0,0,13,0,25
1096,10,1,1,0,0,6,1,19
1097,7,0,0,0,0,6,0,13
1098,8,1,0,0,0,5,0,14
1099,7,1,0,0,0,13,0,21
1100,6,1,1,0,0,10,0,18
1101,13,2,0,0,0,5,2,22
1102,7,1,1,0,0,9,0,18
1103,13,2,1,0,0,4,2,22
1104,11,2,0,0,0,4,1,18
1105,10,0,0,0,0,5,0,15
1106,7,0,0,0,0,2,2,11
1107,8,0,1,0,0,4,0,13
1108,9,0,0,0,0,8,1,18
1109,6,1,0,0,0,6,1,14
1110,15,0,0,0,0,8,0,23
1111,10,0,0,0,0,8,1,19
1112,8,0,0,0,0,6,0,14
1113,7,0,1,0,0,5,0,13
1114,11,0,0,0,0,4,0,15
1115,4,0,0,0,0,6,1,11
1116,13,1,0,0,0,10,2,26
1117,11,2,0,0,0,6,2,21
1118,7,0,1,0,0,6,1,15
1119,8,1,0,0,0,6,0,15
1120,21,1,0,0,0,5,2,29
1121,7,0,0,0,0,5,0,12
1122,7,0,0,0,0,10,0,17
1123,11,0,1,0,0,11,2,25
1124,12,1,0,0,0,8,1,22
1125,8,0,0,0,0,8,1,17
1126,13,0,0,0,0,7,2,22
1127,8,0,0,0,0,7,2,17
1128,13,0,0,0,0,5,0,18
1129,11,0,0,0,0,5,2,18
1130,12,0,0,0,0,2,1,15
1131,8,1,0,0,0,8,1,18
1132,17,1,1,0,0,4,0,23
1133,11,0,0,0,0,9,0,20
1134,13,0,0,0,0,9,0,22
1135,7,1,0,0,0,7,0,15
1136,10,0,1,0,0,7,0,18
1137,7,0,2,0,0,9,0,18
1138,16,0,0,0,0,6,0,22
1139,11,0,0,0,0,5,1,17
1140,6,0,0,0,0,12,1,19
1141,8,0,0,0,0,8,0,16
1142,12,0,0,0,0,8,1,21
1143,10,0,0,0,0,2,0,12
1144,12,1,0,0,0,6,0,19
1145,9,1,0,0,0,8,0,18
1146,8,1,1,0,0,6,1,17
1147,12,0,0,0,0,0,1,13
1148,9,0,0,0,0,7,1,17
1149,13,0,0,0,0,6,0,19
1150,16,0,0,0,0,4,2,22
1151,10,0,0,0,0,4,1,15
1152,11,0,0,0,0,2,2,15
1153,0,2,1,0,0,8,2,13
1154,9,0,1,0,0,13,0,23
1155,18,0,2,0,0,9,0,29
1156,10,0,0,0,0,6,0,16
1157,6,0,0,0,0,8,1,15
1158,12,0,0,0,0,4,1,17
1159,6,0,0,0,0,5,0,11
1160,12,0,1,0,0,7,1,21
1161,13,1,0,0,0,6,1,21
1162,8,0,0,0,0,4,0,12
1163,12,0,1,0,0,3,1,17
1164,6,0,1,0,0,5,0,12
1165,13,1,0,0,0,4,0,18
1166,19,0,0,0,0,6,1,26
1167,15,0,1,0,0,5,0,21
1168,13,0,1,0,0,6,0,20
1169,7,1,0,0,0,4,0,12
1170,9,0,0,0,0,1,0,10
1171,12,0,1,0,0,7,1,21
1172,12,0,0,0,0,3,0,15
1173,15,0,0,0,0,10,1,26
1174,6,0,0,0,0,8,0,14
1175,10,1,0,0,0,1,0,12
1176,8,0,0,0,0,7,1,16
1177,15,0,1,0,0,9,2,27
1178,7,0,0,0,0,1,1,9
1179,13,0,0,0,0,7,0,20
1180,6,1,1,0,0,1,0,9
1181,6,2,1,0,0,6,0,15
1182,10,0,0,0,0,4,1,15
1183,13,0,0,0,0,4,1,18
1184,9,1,1,0,0,6,1,18
1185,7,0,0,0,0,3,1,11
1186,14,1,0,0,0,9,1,25
1187,8,0,0,0,0,7,1,16
1188,6,1,0,0,0,4,1,12
1189,11,1,0,0,0,2,1,15
1190,3,1,1,0,0,8,0,13
1191,12,0,1,0,0,6,0,19
1192,9,0,1,0,0,7,2,19
1193,9,0,0,0,0,4,0,13
1194,8,0,0,0,0,9,1,18
1195,11,0,0,0,0,3,2,16
1196,12,1,0,0,0,7,0,20
1197,5,0,0,0,0,7,0,12
1198,9,0,1,0,0,11,0,21
1199,7,0,0,0,0,4,2,13
1200,15,1,0,0,0,8,0,24
1201,14,1,0,0,0,6,1,22
1202,7,0,0,0,0,6,0,13
1203,8,1,1,0,0,5,1,16
1204,6,0,0,0,0,7,1,14
1205,9,0,0,0,0,5,1,15
1206,10,0,0,0,0,8,0,18
1207,4,1,0,0,0,2,1,8
1208,9,0,0,0,0,9,1,19
1209,12,0,1,0,0,6,0,19
1210,12,1,1,0,0,3,1,18
1211,6,0,2,0,0,3,0,11
1212,12,0,0,0,0,3,0,15
1213,11,2,0,0,0,6,0,19
1214,2,1,1,0,0,3,0,7
1215,10,0,1,0,0,8,0,19
1216,11,0,0,0,0,4,0,15
1217,14,2,1,0,0,4,0,21
1218,9,0,0,0,0,4,1,14
1219,15,0,0,0,0,8,0,23
1220,15,0,0,0,0,6,0,21
1221,10,1,1,0,0,5,0,17
1222,13,0,0,0,0,7,0,20
1223,11,0,0,0,0,7,0,18
1224,9,0,0,0,0,5,0,14
1225,12,0,0,0,0,11,1,24
1226,8,1,0,0,0,5,2,16
1227,11,1,0,0,0,3,0,15
1228,8,1,2,0,0,6,1,18
1229,9,1,0,0,0,2,0,12
1230,14,2,0,0,0,4,0,20
1231,9,0,0,0,0,4,0,13
1232,7,0,0,0,0,7,0,14
1233,9,0,0,0,0,5,2,16
1234,5,1,0,0,0,6,1,13
1235,6,2,0,0,0,5,0,13
1236,11,1,0,0,0,4,0,16
1237,14,0,0,0,0,4,0,18
1238,13,1,0,0,0,7,1,22
1239,11,1,0,0,0,9,1,22
1240,17,0,1,0,0,10,1,29
1241,6,0,1,0,0,1,0,8
1242,11,0,1,0,0,4,0,16
1243,8,0,1,0,0,3,0,12
1244,11,0,0,0,0,7,1,19
1245,15,0,0,0,0,1,1,17
1246,8,0,0,0,0,4,0,12
1247,14,0,0,0,0,4,0,18
1248,10,1,0,0,0,2,2,15
1249,6,1,1,0,0,1,0,9
1250,16,1,1,0,0,3,1,22
1251,10,1,0,0,0,8,0,19
1252,7,0,1,0,0,7,0,15
1253,15,0,1,0,0,9,0,25
1254,8,0,3,0,0,6,1,18
1255,12,0,1,0,0,1,1,15
1256,15,0,0,0,0,11,0,26
1257,13,1,0,0,0,9,0,23
1258,6,0,0,0,0,3,1,10
1259,11,0,1,0,0,6,1,19
1260,9,1,0,1,0,7,0,18
1261,12,0,1,0,0,3,2,18
1262,8,1,0,0,0,3,0,12
1263,18,0,2,0,0,8,0,28
1264,15,0,1,0,0,10,1,27
1265,10,0,0,0,0,6,0,16
1266,10,1,0,0,0,3,0,14
1267,11,0,0,0,0,5,1,17
1268,10,0,0,0,0,7,0,17
1269,10,0,1,0,0,5,0,16
1270,7,0,0,0,0,7,0,14
1271,10,0,0,0,0,4,1,15
1272,12,0,0,0,0,3,0,15
1273,11,0,0,0,0,6,1,18
1274,10,0,0,0,0,6,0,16
1275,13,0,1,0,0,4,0,18
1276,5,0,0,0,0,5,2,12
1277,8,0,0,0,0,3,0,11
1278,8,0,0,0,0,6,0,14
1279,5,0,0,0,0,2,1,8
1280,14,2,0,0,0,5,0,21
1281,10,0,0,0,0,3,0,13
1282,9,1,0,0,0,4,0,14
1283,5,0,0,0,0,5,0,10
1284,7,0,0,0,0,4,0,11
1285,7,1,1,0,0,6,0,15
1286,13,0,0,0,0,5,1,19
1287,7,0,2,0,0,4,0,13
1288,7,0,0,0,0,10,0,17
1289,9,1,0,0,0,5,0,15
1290,8,0,0,0,0,8,0,16
1291,12,1,0,0,0,4,0,17
1292,12,1,0,0,0,7,0,20
1293,6,1,0,0,0,3,1,11
1294,8,1,1,0,0,1,0,11
1295,10,0,0,0,0,4,0,14
1296,8,0,0,0,0,6,0,14
1297,6,1,1,0,0,4,0,12
1298,13,0,0,0,0,5,0,18
1299,6,0,0,0,0,1,0,7
1300,21,0,0,0,0,6,0,27
1301,10,0,0,0,0,4,0,14
1302,14,1,0,0,0,3,0,18
1303,7,0,1,0,0,7,0,15
1304,10,1,0,0,0,2,1,14
1305,7,0,0,0,0,4,0,11
1306,12,0,1,0,0,1,0,14
1307,4,0,0,0,0,4,0,8
1308,8,0,1,0,0,3,0,12
1309,9,0,0,0,0,3,0,12
1310,8,0,0,0,0,5,0,13
1311,10,1,0,0,0,7,0,18
1312,9,1,0,0,0,3,1,14
1313,7,0,0,0,0,5,1,13
1314,7,1,0,0,0,6,1,15
1315,10,0,0,0,0,0,0,10
1316,3,0,2,0,0,2,0,7
1317,8,1,0,0,0,1,0,10
1318,8,0,1,0,0,3,2,14
1319,7,0,1,0,0,6,0,14
1320,13,1,0,0,0,6,2,22
1321,8,0,2,0,0,8,0,18
1322,5,0,1,0,0,5,1,12
1323,7,0,0,0,0,2,1,10
1324,12,0,0,0,0,5,0,17
1325,7,0,0,0,0,4,0,11
1326,10,1,0,0,0,3,0,14
1327,7,0,0,0,0,2,0,9
1328,9,0,0,0,0,3,2,14
1329,9,0,0,0,0,2,0,11
1330,4,1,0,0,0,6,1,12
1331,8,0,0,0,0,4,1,13
1332,15,0,0,0,0,3,1,19
1333,7,0,1,0,0,7,0,15
1334,9,1,0,0,0,0,2,12
1335,8,0,0,0,0,0,1,9
1336,13,0,0,0,0,5,0,18
1337,14,0,0,0,0,1,1,16
1338,11,0,0,0,0,4,1,16
1339,17,0,1,0,0,5,0,23
1340,10,1,0,0,0,4,0,15
1341,7,0,1,0,0,3,0,11
1342,8,0,0,0,0,2,0,10
1343,8,0,0,0,0,1,1,10
1344,13,1,0,0,0,2,0,16
1345,11,0,0,0,0,3,0,14
1346,10,0,0,0,0,3,0,13
1347,8,1,1,0,0,4,1,15
1348,13,0,0,0,0,5,0,18
1349,9,2,0,0,0,2,0,13
1350,5,0,0,0,0,4,0,9
1351,9,1,0,0,0,0,0,10
1352,5,0,0,0,0,4,0,9
1353,9,0,0,0,0,4,0,13
1354,8,0,1,0,0,5,0,14
1355,4,0,0,0,0,3,0,7
1356,4,0,0,0,0,4,1,9
1357,6,1,0,0,0,0,1,8
1358,8,2,0,0,0,1,0,11
1359,3,0,0,0,0,5,0,8
1360,17,1,0,0,0,2,0,20
1361,10,2,2,0,0,2,1,17
1362,7,1,2,0,0,2,0,12
1363,10,0,0,0,0,5,0,15
1364,7,0,1,0,0,3,0,11
1365,4,0,0,0,0,2,0,6
1366,13,1,0,0,0,5,2,21
1367,11,1,0,0,0,3,1,16
1368,16,0,0,0,0,4,0,20
1369,6,0,0,0,0,6,0,12
1370,9,0,0,0,0,4,0,13
1371,12,0,0,0,0,3,1,16
1372,6,1,0,0,0,2,0,9
1373,13,1,0,0,0,4,1,19
1374,11,1,0,0,0,3,0,15
1375,6,0,0,0,0,5,0,11
1376,12,1,0,0,0,8,0,21
1377,10,1,0,0,0,3,0,14
1378,6,1,2,0,0,4,0,13
1379,10,0,0,0,0,4,1,15
1380,11,0,0,0,0,4,0,15
1381,11,0,0,0,0,1,1,13
1382,7,0,1,0,0,4,1,13
1383,7,0,0,0,0,1,0,8
1384,10,1,0,0,0,3,1,15
1385,12,0,0,0,0,4,1,17
1386,5,0,0,0,0,2,0,7
1387,5,1,1,0,0,3,0,10
1388,8,2,0,0,0,2,0,12
1389,11,0,0,0,0,7,0,18
1390,11,0,0,0,0,1,0,12
1391,14,1,0,0,0,2,0,17
1392,7,0,0,0,0,2,1,10
1393,7,0,0,0,0,7,1,15
1394,12,0,0,0,0,2,0,14
1395,14,0,0,0,0,3,1,18
1396,3,0,0,0,0,6,1,10
1397,14,2,0,0,0,2,0,18
1398,6,0,1,0,0,9,0,16
1399,5,0,0,0,0,6,0,11
1400,52,1,0,0,0,4,0,57
1401,11,0,0,0,0,3,1,15
1402,9,2,0,0,0,2,0,13
1403,3,1,0,0,0,3,0,7
1404,5,0,0,0,0,4,1,10
1405,8,0,0,0,0,3,1,12
1406,7,1,0,0,0,4,0,12
1407,8,0,0,0,0,2,1,11
1408,7,0,1,0,0,5,1,14
1409,9,1,0,0,0,3,1,14
1410,8,0,0,0,0,4,0,12
1411,8,0,0,0,0,6,0,14
1412,4,1,1,0,0,2,0,8
1413,2,0,1,0,0,6,0,9
1414,6,0,0,0,0,5,1,12
1415,8,1,1,0,0,1,0,11
1416,11,0,0,0,0,3,0,14
1417,3,0,2,0,0,0,0,5
1418,12,1,0,0,0,1,0,14
1419,5,0,0,0,0,3,0,8
1420,9,0,1,0,0,0,2,12
1421,7,0,0,0,0,7,0,14
1422,10,0,0,0,0,2,0,12
1423,9,0,0,0,0,5,0,14
1424,7,2,1,0,0,0,0,10
1425,5,0,0,0,0,5,0,10
1426,8,0,0,0,0,4,0,12
1427,7,0,0,0,0,0,2,9
1428,2,0,0,0,0,3,1,6
1429,10,0,0,0,0,2,0,12
1430,7,0,0,0,0,4,0,11
1431,4,0,0,0,0,5,0,9
1432,9,1,0,0,0,4,1,15
1433,11,0,0,0,0,3,1,15
1434,5,1,1,0,0,2,0,9
1435,8,0,0,0,0,6,0,14
1436,7,0,0,0,0,3,0,10
1437,4,0,0,0,0,3,0,7
1438,7,1,1,0,0,5,0,14
1439,2,0,0,0,0,6,0,8
1440,17,0,3,0,0,0,2,22
1441,6,0,0,0,0,1,0,7
1442,5,1,0,0,0,4,3,13
1443,6,0,0,0,0,3,0,9
1444,4,1,0,0,0,4,0,9
1445,9,0,0,0,0,4,0,13
1446,8,1,0,0,0,0,0,9
1447,9,0,0,0,0,2,1,12
1448,11,0,0,0,0,0,1,12
1449,11,0,0,0,0,2,0,13
1450,4,0,0,0,0,4,0,8
1451,6,0,0,0,0,3,0,9
1452,11,0,1,0,0,3,0,15
1453,5,1,0,0,0,3,0,9
1454,4,0,0,0,0,1,0,5
1455,11,1,1,0,0,3,1,17
1456,5,0,0,0,0,4,2,11
1457,8,0,0,0,0,1,0,9
1458,4,0,1,0,0,1,1,7
1459,3,0,0,0,0,2,1,6
1460,5,0,1,0,0,2,0,8
1461,2,0,0,0,0,4,1,7
1462,5,1,0,0,0,5,0,11
1463,5,0,0,0,0,2,0,7
1464,3,0,0,0,0,1,1,5
1465,3,0,0,0,0,1,0,4
1466,13,1,1,0,0,4,0,19
1467,6,2,0,0,0,3,0,11
1468,10,0,0,0,0,3,0,13
1469,14,0,0,0,0,3,0,17
1470,7,1,0,0,0,3,0,11
1471,7,0,0,0,0,6,1,14
1472,10,0,0,0,0,1,0,11
1473,5,0,0,0,0,2,0,7
1474,13,0,0,0,0,1,0,14
1475,12,0,0,0,0,0,0,12
1476,8,0,0,0,0,1,0,9
1477,11,1,0,0,0,4,1,17
1478,9,0,0,0,0,2,1,12
1479,8,0,0,0,0,3,0,11
1480,7,0,1,0,0,1,0,9
1481,6,0,0,0,0,3,0,9
1482,9,0,0,0,0,1,0,10
1483,4,1,0,0,0,0,1,6
1484,6,0,0,0,0,2,0,8
1485,9,0,0,0,0,4,1,14
1486,10,0,1,0,0,3,0,14
1487,11,0,0,0,0,3,1,15
1488,12,0,0,0,0,3,0,15
1489,12,0,0,0,0,2,0,14
1490,12,0,2,0,0,1,0,15
1491,7,1,0,0,0,0,0,8
1492,7,0,0,0,0,1,0,8
1493,9,0,0,0,0,3,1,13
1494,7,1,0,0,0,2,0,10
1495,5,0,0,0,0,1,0,6
1496,8,0,1,0,0,0,1,10
1497,3,2,1,0,0,5,0,11
1498,4,0,1,0,0,3,0,8
1499,6,2,0,0,0,3,0,11
1500,9,0,0,0,0,2,2,13
1501,8,1,0,0,0,4,1,14
1502,4,0,0,0,0,3,0,7
1503,7,1,0,0,0,4,0,12
1504,5,1,0,0,0,3,0,9
1505,8,1,0,0,0,3,0,12
1506,2,1,1,0,0,3,0,7
1507,4,0,0,0,0,1,0,5
1508,8,0,0,0,0,3,0,11
1509,7,1,0,0,0,2,0,10
1510,9,0,0,0,0,1,0,10
1511,8,0,1,0,0,6,1,16
1512,7,0,0,0,0,0,0,7
1513,8,0,0,0,0,3,0,11
1514,5,0,0,0,0,1,1,7
1515,9,0,1,0,0,1,1,12
1516,6,0,1,0,0,2,1,10
1517,5,1,1,0,0,3,0,10
1518,4,0,0,0,0,5,0,9
1519,5,1,2,0,0,3,0,11
1520,21,0,2,0,0,4,1,28
1521,8,0,0,0,0,1,0,9
1522,10,0,0,0,0,0,0,10
1523,8,0,0,0,0,1,0,9
1524,6,0,0,0,0,3,0,9
1525,10,0,0,0,0,3,0,13
1526,9,0,0,0,0,2,0,11
1527,11,0,0,0,0,4,0,15
1528,7,0,0,0,0,1,0,8
1529,2,0,0,0,0,4,0,6
1530,9,0,0,0,0,2,1,12
1531,6,0,0,0,0,2,0,8
1532,6,0,0,0,0,1,1,8
1533,7,0,0,0,0,0,0,7
1534,5,0,0,0,0,1,0,6
1535,4,0,0,0,0,1,0,5
1536,4,1,1,0,0,4,1,11
1537,9,0,2,0,0,4,0,15
1538,9,0,0,0,0,3,0,12
1539,8,0,0,0,0,1,1,10
1540,10,1,0,0,0,2,2,15
1541,6,1,0,0,0,3,0,10
1542,7,0,0,0,0,4,0,11
1543,3,0,0,0,0,1,0,4
1544,11,1,0,0,0,1,0,13
1545,6,0,0,0,0,2,0,8
1546,8,0,0,0,0,0,0,8
1547,9,0,2,0,0,2,0,13
1548,3,0,1,0,0,1,1,6
1549,7,1,0,0,0,1,0,9
1550,6,0,0,0,0,1,0,7
1551,4,0,0,0,0,1,0,5
1552,6,0,0,0,0,1,0,7
1553,6,0,0,0,0,2,0,8
1554,4,0,1,0,0,5,0,10
1555,8,0,1,0,0,3,0,12
1556,4,1,1,0,0,2,0,8
1557,6,2,0,0,0,0,0,8
1558,3,0,0,0,0,4,0,7
1559,10,1,0,0,0,2,0,13
1560,12,1,1,0,0,4,0,18
1561,2,1,0,0,0,2,2,7
1562,5,0,0,0,0,2,0,7
1563,5,0,0,0,0,1,0,6
1564,3,0,0,0,0,5,0,8
1565,3,0,0,0,0,3,0,6
1566,3,0,0,0,0,1,0,4
1567,6,0,0,0,0,3,0,9
1568,10,0,0,0,0,1,0,11
1569,8,0,0,0,0,1,0,9
1570,11,0,0,0,0,2,0,13
1571,6,0,0,0,0,0,1,7
1572,11,0,0,0,0,4,0,15
1573,2,0,2,0,0,4,0,8
1574,9,0,0,0,0,2,0,11
1575,5,0,1,0,0,2,0,8
1576,11,0,0,0,0,1,1,13
1577,7,0,0,0,0,1,0,8
1578,3,0,1,0,0,1,0,5
1579,5,1,0,0,0,2,0,8
1580,6,0,0,0,0,3,0,9
1581,4,0,0,0,0,1,0,5
1582,6,0,0,0,0,1,0,7
1583,3,0,0,0,0,2,0,5
1584,11,0,0,0,0,1,0,12
1585,5,0,0,0,0,2,0,7
1586,5,0,1,0,0,1,0,7
1587,3,0,0,0,0,0,0,3
1588,6,0,0,0,0,2,1,9
1589,5,0,0,0,0,2,0,7
1590,3,0,1,0,0,2,0,6
1591,8,0,1,0,0,1,0,10
1592,5,0,0,0,0,0,0,5
1593,9,1,2,0,0,3,0,15
1594,6,1,0,0,0,2,0,9
1595,12,1,0,0,0,1,0,14
1596,11,0,0,0,0,2,0,13
1597,4,0,1,0,0,2,1,8
1598,4,0,2,0,0,3,0,9
1599,5,1,0,0,0,3,0,9
1600,12,0,2,0,0,5,0,19
1601,5,0,0,0,0,3,1,9
1602,6,0,0,0,0,3,0,9
1603,5,0,0,0,0,1,0,6
1604,7,0,0,0,0,0,1,8
1605,10,0,0,0,0,1,0,11
1606,3,0,0,0,0,0,0,3
1607,5,0,0,0,0,3,2,10
1608,2,0,0,0,0,3,0,5
1609,8,0,0,0,0,1,0,9
1610,8,1,0,0,0,6,0,15
1611,3,0,0,0,0,3,0,6
1612,7,0,0,0,0,1,0,8
1613,7,0,0,0,0,1,0,8
1614,8,0,1,0,0,3,0,12
1615,10,0,0,0,0,1,0,11
1616,5,0,0,0,0,0,0,5
1617,3,0,0,0,0,2,1,6
1618,8,0,0,0,0,1,0,9
1619,4,0,0,0,0,1,0,5
1620,4,1,0,0,0,2,0,7
1621,7,0,0,0,0,0,0,7
1622,8,2,0,0,0,1,0,11
1623,9,0,0,0,0,2,0,11
1624,4,1,0,0,0,1,0,6
1625,2,1,0,0,0,3,1,7
1626,3,0,1,0,0,1,1,6
1627,10,0,0,0,0,1,1,12
1628,7,0,0,0,0,1,1,9
1629,10,0,0,0,0,4,0,14
1630,8,0,0,0,0,1,0,9
1631,4,1,1,0,0,1,1,8
1632,4,0,0,0,0,0,0,4
1633,8,0,0,0,0,0,0,8
1634,3,0,0,0,0,1,1,5
1635,1,0,0,0,0,0,0,1
1636,8,0,1,0,0,7,0,16
1637,6,1,0,0,0,0,0,7
1638,9,0,0,0,0,0,0,9
1639,5,0,0,0,0,0,0,5
1640,5,1,0,0,0,1,0,7
1641,5,0,0,0,0,1,1,7
1642,5,0,0,0,0,2,0,7
1643,9,0,0,0,0,0,0,9
1644,4,0,0,0,0,0,0,4
1645,2,0,0,0,0,1,0,3
1646,4,0,0,0,0,0,0,4
1647,5,1,2,0,0,2,0,10
1648,3,0,0,0,0,2,0,5
1649,8,0,1,0,0,1,0,10
1650,6,1,0,0,0,1,0,8
1651,4,0,0,0,0,1,0,5
1652,4,0,0,0,0,0,0,4
1653,4,0,0,0,0,1,0,5
1654,6,0,0,0,0,2,0,8
1655,5,0,0,0,0,1,0,6
1656,6,0,0,0,0,2,0,8
1657,5,0,0,0,0,2,0,7
1658,5,0,0,0,0,1,0,6
1659,8,0,0,0,0,1,0,9
1660,11,0,0,0,0,5,0,16
1661,5,2,0,0,0,3,0,10
1662,3,0,0,0,0,0,1,4
1663,3,0,0,0,0,2,0,5
1664,4,0,0,0,0,2,0,6
1665,5,1,0,0,0,4,1,11
1666,10,1,1,0,0,2,1,15
1667,7,0,0,0,0,4,0,11
1668,8,0,0,0,0,1,1,10
1669,9,0,0,0,0,1,0,10
1670,3,0,0,0,0,2,1,6
1671,4,0,0,0,0,3,0,7
1672,8,0,0,0,0,0,1,9
1673,7,0,0,0,0,3,0,10
1674,6,0,0,0,0,2,0,8
1675,2,0,1,0,0,0,0,3
1676,5,0,0,0,0,3,0,8
1677,5,0,0,0,0,1,0,6
1678,2,0,0,0,0,3,0,5
1679,7,0,0,0,0,1,0,8
1680,13,2,1,0,0,3,0,19
1681,3,0,1,0,0,2,1,7
1682,3,1,0,0,0,1,0,5
1683,2,0,0,0,0,2,0,4
1684,4,0,0,0,0,4,1,9
1685,7,0,0,0,0,0,0,7
1686,4,1,0,0,0,1,0,6
1687,6,1,0,0,0,2,0,9
1688,7,0,1,0,0,4,1,13
1689,4,0,0,0,0,0,1,5
1690,2,0,0,0,0,0,1,3
1691,8,0,1,0,0,0,0,9
1692,9,0,0,0,0,1,0,10
1693,7,0,0,0,0,0,0,7
1694,8,1,0,0,0,1,2,12
1695,7,0,0,0,0,3,0,10
1696,8,0,1,0,0,2,0,11
1697,3,0,1,0,0,1,0,5
1698,8,0,1,0,0,1,0,10
1699,8,0,0,0,0,1,1,10
1700,7,0,0,0,0,2,0,9
1701,2,1,0,0,0,4,0,7
1702,7,0,1,0,0,0,0,8
1703,5,0,0,0,0,1,1,7
1704,4,0,0,0,0,2,0,6
1705,2,0,0,0,0,1,0,3
1706,3,0,1,0,0,0,1,5
1707,3,0,0,0,0,2,1,6
1708,5,0,0,0,0,1,0,6
1709,9,1,0,0,0,4,0,14
1710,4,0,0,0,0,0,1,5
1711,7,1,0,0,0,1,0,9
1712,6,0,0,0,0,2,0,8
1713,2,1,0,0,0,0,1,4
1714,7,0,0,0,0,2,0,9
1715,3,0,0,0,0,3,0,6
1716,3,0,1,1,0,4,0,9
1717,5,1,0,0,0,1,0,7
1718,4,1,0,0,0,2,0,7
1719,7,1,0,0,0,0,1,9
1720,7,1,1,0,0,1,1,11
1721,8,0,2,0,0,2,0,12
1722,5,0,0,0,0,1,0,6
1723,4,0,0,0,0,3,1,8
1724,3,1,0,0,0,2,0,6
1725,3,0,1,0,0,1,0,5
1726,0,0,0,0,0,2,0,2
1727,8,2,0,0,0,1,1,12
1728,6,0,0,0,0,2,0,8
1729,7,0,0,0,0,2,0,9
1730,6,0,0,0,0,4,0,10
1731,8,0,0,0,0,0,0,8
1732,5,0,0,0,0,1,0,6
1733,5,0,1,0,0,1,0,7
1734,9,0,0,0,0,2,1,12
1735,2,0,0,0,0,0,0,2
1736,6,0,0,0,0,1,0,7
1737,4,0,0,0,0,2,0,6
1738,3,0,1,0,0,1,0,5
1739,3,0,0,0,0,4,2,9
1740,4,0,0,0,0,4,1,9
1741,6,0,0,0,0,2,0,8
1742,6,1,1,0,0,0,0,8
1743,6,0,0,0,0,2,0,8
1744,5,0,0,0,0,3,0,8
1745,6,0,0,0,0,0,0,6
1746,5,0,0,0,0,0,0,5
1747,8,0,0,0,0,3,0,11
1748,4,0,0,0,0,0,1,5
1749,7,0,0,0,0,0,0,7
1750,8,0,0,0,0,1,0,9
1751,4,0,0,0,0,0,0,4
1752,10,1,0,0,0,4,0,15
1753,2,0,0,0,0,1,0,3
1754,5,0,0,0,0,1,0,6
1755,8,0,0,0,0,0,1,9
1756,6,0,1,0,0,4,0,11
1757,4,0,0,0,0,0,0,4
1758,4,0,0,0,0,2,1,7
1759,3,0,0,0,0,1,0,4
1760,12,0,3,0,0,2,0,17
1761,4,1,0,0,0,1,0,6
1762,7,1,0,0,0,2,1,11
1763,1,0,0,0,0,1,0,2
1764,2,0,0,0,0,0,1,3
1765,6,0,0,0,0,2,0,8
1766,8,0,0,0,0,2,1,11
1767,2,0,0,0,0,1,0,3
1768,6,0,0,0,0,0,0,6
1769,4,0,1,0,0,0,0,5
1770,3,0,0,0,0,0,0,3
1771,4,0,0,0,0,0,1,5
1772,6,0,0,0,0,0,1,7
1773,3,1,0,0,0,0,0,4
1774,2,0,0,0,0,1,0,3
1775,4,0,0,0,0,0,0,4
1776,3,0,0,0,0,0,1,4
1777,10,0,0,0,0,1,0,11
1778,5,0,1,0,0,0,0,6
1779,4,0,0,0,0,3,0,7
1780,3,0,0,0,0,4,0,7
1781,5,0,0,0,0,2,0,7
1782,5,0,0,0,0,0,0,5
1783,4,0,0,0,0,1,0,5
1784,5,0,0,0,0,1,0,6
1785,9,0,0,0,0,0,1,10
1786,2,0,0,0,0,0,0,2
1787,7,0,0,0,0,0,0,7
1788,2,0,0,0,0,1,0,3
1789,5,0,0,0,0,2,0,7
1790,4,0,0,0,0,3,0,7
1791,2,1,0,0,0,1,0,4
1792,4,0,0,0,0,1,0,5
1793,3,0,0,0,0,2,0,5
1794,6,0,0,0,0,2,0,8
1795,5,1,0,0,0,1,0,7
1796,10,0,0,0,0,1,0,11
1797,4,0,0,0,0,1,0,5
1798,6,0,0,0,0,2,0,8
1799,4,0,0,0,0,3,0,7
1800,16,0,1,0,0,0,0,17
1801,7,0,0,0,0,2,0,9
1802,5,0,0,0,0,1,0,6
1803,2,0,0,0,0,0,0,2
1804,5,0,0,0,0,2,0,7
1805,6,0,0,0,0,1,0,7
1806,0,0,0,0,0,1,1,2
1807,1,0,0,0,0,3,0,4
1808,7,0,1,0,0,2,0,10
1809,5,0,0,0,0,0,0,5
1810,6,0,0,0,0,1,0,7
1811,5,0,0,0,0,0,0,5
1812,4,1,0,0,0,1,0,6
1813,1,2,0,0,0,2,0,5
1814,5,0,0,0,0,4,0,9
1815,5,0,0,0,0,0,0,5
1816,6,0,1,0,0,1,0,8
1817,5,0,1,0,0,0,0,6
1818,3,0,0,0,0,0,1,4
1819,11,0,0,0,0,0,0,11
1820,4,0,0,0,0,0,0,4
1821,4,1,0,0,0,3,0,8
1822,5,0,0,0,0,0,0,5
1823,5,0,0,0,0,1,0,6
1824,3,0,0,0,0,0,0,3
1825,4,0,0,0,0,1,0,5
1826,39,0,1,0,0,2,0,42
1827,10,0,0,0,0,4,0,14
1828,5,1,0,0,0,1,1,8
1829,6,0,0,0,0,0,0,6
1830,6,0,0,0,0,0,1,7
1831,5,0,0,0,0,1,0,6
1832,5,0,0,0,0,1,0,6
1833,6,0,1,0,0,1,0,8
1834,9,0,0,0,0,6,0,15
1835,6,0,0,0,0,1,0,7
1836,4,0,0,0,0,0,0,4
1837,5,0,0,0,0,1,0,6
1838,5,1,0,0,0,2,0,8
1839,3,1,0,0,0,0,0,4
1840,13,2,0,0,0,1,0,16
1841,6,0,1,0,0,0,0,7
1842,8,0,0,0,0,1,0,9
1843,10,0,0,0,0,3,0,13
1844,4,0,0,0,0,2,0,6
1845,1,0,0,0,0,0,0,1
1846,7,0,0,0,0,0,0,7
1847,7,0,0,0,0,2,0,9
1848,8,0,0,0,0,0,0,8
1849,4,0,0,0,0,2,0,6
1850,4,1,0,0,0,1,0,6
1851,6,1,0,0,0,2,0,9
1852,7,0,1,0,0,1,0,9
1853,4,0,0,0,0,1,0,5
1854,9,0,0,0,0,2,0,11
1855,3,0,0,0,0,0,0,3
1856,3,0,0,0,0,1,0,4
1857,5,0,0,0,0,1,0,6
1858,4,0,0,0,0,5,0,9
1859,4,0,0,0,0,0,0,4
1860,3,0,0,0,0,3,0,6
1861,3,0,0,0,0,4,0,7
1862,7,0,0,0,0,0,0,7
1863,6,0,0,0,0,0,0,6
1864,8,0,0,0,0,0,0,8
1865,4,0,0,0,0,1,0,5
1866,6,1,0,0,0,0,0,7
1867,5,0,0,0,0,0,0,5
1868,3,0,1,0,0,0,0,4
1869,6,0,0,0,0,0,0,6
1870,6,0,2,0,0,3,0,11
1871,6,0,0,0,0,1,0,7
1872,5,0,1,0,0,1,0,7
1873,5,0,0,0,0,2,1,8
1874,5,0,2,0,0,1,0,8
1875,2,0,0,0,0,0,0,2
1876,11,0,0,0,0,1,0,12
1877,7,0,1,0,0,2,0,10
1878,8,0,0,0,0,0,0,8
1879,1,0,1,0,0,0,1,3
1880,10,0,0,0,0,0,0,10
1881,6,0,0,0,0,2,0,8
1882,5,0,0,0,0,1,0,6
1883,7,0,0,0,0,1,0,8
1884,4,1,0,0,0,0,0,5
1885,8,0,0,0,0,2,0,10
1886,5,0,0,0,0,3,0,8
1887,6,0,0,0,0,1,0,7
1888,4,0,0,0,0,1,0,5
1889,7,0,1,0,0,0,0,8
1890,5,1,0,0,0,1,0,7
1891,2,0,0,0,0,0,0,2
1892,7,0,0,0,0,2,0,9
1893,3,0,0,0,0,1,0,4
1894,7,1,0,0,0,0,0,8
1895,5,0,0,0,0,2,0,7
1896,2,0,1,0,0,0,0,3
1897,3,0,0,0,0,0,0,3
1898,4,0,0,0,0,1,1,6
1899,3,0,0,0,0,1,0,4
1900,5,1,1,0,0,1,1,9
1901,4,0,0,0,0,4,0,8
1902,3,0,0,0,0,0,0,3
1903,4,0,0,0,0,2,0,6
1904,5,0,0,0,0,0,0,5
1905,6,1,0,0,0,2,0,9
1906,0,0,0,0,0,1,0,1
1907,5,0,0,0,0,0,0,5
1908,9,0,0,0,0,3,0,12
1909,2,0,0,0,0,1,0,3
1910,2,1,0,0,0,0,0,3
1911,3,0,0,0,0,0,0,3
1912,5,0,1,0,0,1,0,7
1913,0,0,0,0,0,2,0,2
1914,5,1,0,0,0,1,0,7
1915,2,0,0,0,0,1,1,4
1916,3,0,0,0,0,2,0,5
1917,1,0,0,0,0,1,0,2
1918,12,0,0,0,0,2,0,14
1919,1,0,0,0,0,0,0,1
1920,12,0,1,0,0,2,0,15
1921,6,0,0,0,0,0,1,7
1922,3,0,0,0,0,0,0,3
1923,5,0,0,0,0,0,0,5
1924,3,0,0,0,0,1,0,4
1925,4,0,1,0,0,0,0,5
1926,6,0,1,0,0,0,0,7
1927,8,0,0,0,0,0,1,9
1928,7,0,1,0,0,1,0,9
1929,5,0,0,0,0,1,0,6
1930,4,0,0,0,0,0,0,4
1931,4,0,0,0,0,1,0,5
1932,3,0,0,0,0,0,0,3
1933,5,0,0,0,0,0,0,5
1934,6,0,1,0,0,5,0,12
1935,6,1,0,0,0,0,0,7
1936,4,0,0,0,0,2,0,6
1937,4,0,0,0,0,1,0,5
1938,6,1,1,0,0,2,0,10
1939,8,0,0,0,0,0,0,8
1940,7,0,0,0,0,0,0,7
1941,5,0,0,0,0,0,0,5
1942,4,0,0,0,0,1,0,5
1943,2,0,0,0,0,1,0,3
1944,4,0,1,0,0,1,0,6
1945,2,0,2,0,0,1,0,5
1946,3,0,0,0,0,1,0,4
1947,3,0,0,0,0,0,0,3
1948,6,0,0,0,0,1,0,7
1949,4,0,0,0,0,1,0,5
1950,8,0,0,0,0,1,0,9
1951,6,0,0,0,0,4,1,11
1952,1,1,0,0,0,5,1,8
1953,5,0,0,0,0,0,0,5
1954,10,0,0,0,0,2,0,12
1955,3,2,0,0,0,0,0,5
1956,1,0,0,0,0,1,0,2
1957,8,0,1,0,0,2,0,11
1958,2,0,0,0,0,0,0,2
1959,1,0,0,0,0,0,0,1
1960,5,1,0,0,0,2,0,8
1961,5,0,0,0,0,0,0,5
1962,2,0,0,0,0,0,0,2
1963,3,0,0,0,0,2,0,5
1964,7,0,0,0,0,0,0,7
1965,6,0,0,0,0,1,0,7
1966,5,0,0,0,0,1,0,6
1967,5,0,0,0,0,1,0,6
1968,1,0,0,0,0,2,0,3
1969,4,0,0,0,0,0,0,4
1970,3,0,1,0,0,3,0,7
1971,3,0,0,0,0,3,0,6
1972,3,0,0,0,0,0,0,3
1973,6,1,0,0,0,0,0,7
1974,5,0,0,0,0,0,0,5
1975,4,0,0,0,0,0,0,4
1976,4,0,0,0,0,0,1,5
1977,5,0,1,0,0,0,0,6
1978,3,0,1,0,0,0,0,4
1979,3,0,0,0,0,1,0,4
1980,3,0,1,0,0,2,0,6
1981,5,1,0,0,0,0,1,7
1982,6,0,0,0,0,1,0,7
1983,3,0,0,0,0,1,0,4
1984,5,0,0,0,0,5,0,10
1985,3,1,0,0,0,0,0,4
1986,2,0,1,0,0,2,0,5
1987,4,0,0,0,0,0,0,4
1988,4,0,0,0,0,1,0,5
1989,1,1,0,0,0,0,0,2
1990,6,0,0,0,0,0,0,6
1991,3,0,0,0,0,1,1,5
1992,7,0,0,0,0,1,0,8
1993,10,0,0,0,0,1,0,11
1994,5,0,0,0,0,1,0,6
1995,4,0,0,0,0,0,0,4
1996,2,1,0,0,0,0,0,3
1997,6,0,0,0,0,2,0,8
1998,4,0,0,0,0,3,0,7
1999,2,0,1,0,0,1,0,4
2000,13,0,3,0,0,1,0,17
2001,6,0,0,0,0,2,0,8
2002,5,0,0,0,0,1,0,6
2003,7,1,0,0,0,0,0,8
2004,3,0,0,0,0,2,0,5
2005,4,0,0,0,0,1,0,5
2006,3,0,0,0,0,0,0,3
2007,4,0,0,0,0,4,0,8
2008,4,0,0,0,0,0,0,4
2009,5,0,0,0,0,0,0,5
2010,9,0,0,0,0,0,0,9
2011,3,1,0,0,0,0,0,4
2012,1,0,0,0,0,0,0,1
2013,8,0,0,0,0,1,0,9
2014,2,0,0,0,0,4,0,6
2015,2,0,0,0,0,1,0,3
2016,7,0,0,0,0,0,1,8
2017,6,0,0,0,0,0,1,7
2018,4,0,1,0,0,0,0,5
2019,7,0,1,0,0,1,1,10
2020,7,0,1,0,0,0,0,8
2021,2,0,0,0,0,0,0,2
2022,2,0,1,0,0,0,0,3
2023,3,0,0,0,0,0,0,3
2024,3,0,1,0,0,3,0,7
2025,4,0,0,0,0,0,0,4
2026,1,0,0,0,0,0,0,1
2027,5,0,1,0,0,2,0,8
2028,4,0,0,0,0,0,0,4
2029,5,0,0,0,0,0,0,5
2030,2,0,0,0,0,2,1,5
2031,3,0,1,0,0,0,0,4
2032,4,0,0,0,0,4,0,8
2033,9,0,0,0,0,0,0,9
2034,7,0,0,0,0,2,0,9
2035,3,0,0,0,0,0,0,3
2036,5,0,0,0,0,0,0,5
2037,5,0,0,0,0,0,0,5
2038,1,0,0,0,0,2,0,3
2039,4,0,0,0,0,1,0,5
2040,11,1,0,0,0,2,0,14
2041,5,0,0,0,0,0,0,5
2042,5,0,0,0,0,0,1,6
2043,4,0,1,0,0,0,0,5
2044,4,1,0,0,0,1,1,7
2045,4,0,0,0,0,0,0,4
2046,8,0,0,0,0,2,0,10
2047,6,0,0,0,0,0,0,6
2048,1,0,0,0,0,1,0,2
2049,4,0,0,0,0,2,0,6
2050,5,0,0,0,0,1,0,6
2051,4,0,0,0,0,0,0,4
2052,2,0,0,0,0,2,0,4
2053,7,0,0,0,0,1,0,8
2054,4,0,0,0,0,1,0,5
2055,3,0,0,0,0,3,0,6
2056,3,0,0,0,0,1,0,4
2057,5,0,0,0,0,0,1,6
2058,2,0,1,0,0,1,0,4
2059,5,0,0,0,0,0,0,5
2060,6,0,0,0,0,1,0,7
2061,7,0,0,0,0,1,0,8
2062,6,0,0,0,0,1,0,7
2063,5,0,0,0,0,0,0,5
2064,4,0,1,0,0,0,0,5
2065,5,0,0,0,0,0,1,6
2066,8,0,0,0,0,0,0,8
2067,4,0,1,0,0,1,0,6
2068,2,0,0,0,0,2,0,4
2069,3,1,0,0,0,0,0,4
2070,5,0,0,0,0,0,0,5
2071,4,0,0,0,0,1,0,5
2072,3,0,0,0,0,0,0,3
2073,2,0,0,0,0,0,0,2
2074,6,0,0,0,0,1,0,7
2075,4,0,0,0,0,0,0,4
2076,4,0,0,0,0,0,0,4
2077,3,1,0,0,0,2,0,6
2078,3,0,0,0,0,0,0,3
2079,4,0,0,0,0,1,0,5
2080,8,0,3,0,0,0,0,11
2081,2,0,1,0,0,0,0,3
2082,4,0,0,0,0,0,1,5
2083,3,1,0,0,0,2,0,6
2084,2,0,0,0,0,1,0,3
2085,1,0,0,0,0,1,0,2
2086,4,0,0,0,0,0,1,5
2087,4,0,0,0,0,1,0,5
2088,5,1,0,0,0,0,0,6
2089,4,0,0,0,0,0,0,4
2090,8,0,0,0,0,0,0,8
2091,6,1,0,0,0,0,0,7
2092,3,0,0,0,0,1,0,4
2093,3,0,1,0,0,2,1,7
2094,4,0,0,0,0,0,0,4
2095,7,0,0,0,0,0,0,7
2096,4,1,0,0,0,1,0,6
2097,1,0,0,0,0,1,0,2
2098,5,0,0,0,0,1,0,6
2099,5,0,0,0,0,0,0,5
2100,15,1,0,0,0,2,0,18
2101,6,1,0,0,0,0,0,7
2102,3,0,0,0,0,0,0,3
2103,2,0,0,0,0,2,0,4
2104,2,0,1,0,0,1,0,4
2105,5,0,0,0,0,0,0,5
2106,6,0,0,0,0,0,0,6
2107,1,0,0,0,0,0,0,1
2108,0,0,0,0,0,2,0,2
2109,2,0,0,0,0,0,0,2
2110,8,0,0,0,0,1,0,9
2111,3,0,0,0,0,0,0,3
2112,3,0,1,0,0,1,0,5
2113,3,1,0,0,0,0,0,4
2114,4,0,0,0,0,2,0,6
2115,2,0,0,0,0,0,0,2
2116,4,0,0,0,0,0,0,4
2117,5,0,1,0,0,0,0,6
2118,2,0,0,0,0,1,0,3
2119,3,0,0,0,0,2,0,5
2120,9,1,0,0,0,3,0,13
2121,4,0,0,0,0,3,0,7
2122,3,1,0,0,0,0,0,4
2123,3,0,0,0,0,0,0,3
2124,3,0,0,0,0,0,0,3
2125,7,0,0,0,0,0,0,7
2126,6,0,0,0,0,0,0,6
2127,3,0,0,0,0,2,0,5
2128,1,0,0,0,0,1,0,2
2129,3,0,0,0,0,1,0,4
2130,2,0,0,0,0,1,0,3
2131,4,0,0,0,0,0,0,4
2132,6,0,0,0,0,0,0,6
2133,4,0,0,0,0,0,0,4
2134,4,0,0,0,0,0,0,4
2135,10,0,0,0,0,1,0,11
2136,7,0,1,0,0,3,0,11
2137,5,0,0,0,0,0,0,5
2138,3,0,0,0,0,0,1,4
2139,4,0,0,0,0,0,1,5
2140,6,0,0,0,0,0,0,6
2141,4,1,0,0,0,1,0,6
2142,3,0,0,0,0,0,0,3
2143,5,0,0,0,0,1,0,6
2144,3,0,1,0,0,1,0,5
2145,5,0,0,0,0,1,0,6
2146,6,0,0,0,0,0,0,6
2147,5,0,0,0,0,0,0,5
2148,1,0,0,0,0,0,0,1
2149,5,0,0,0,0,0,0,5
2150,3,0,0,0,0,0,0,3
2151,7,0,0,0,0,0,0,7
2152,4,1,0,0,0,1,0,6
2153,7,0,0,0,0,1,0,8
2154,4,0,0,0,0,0,0,4
2155,3,0,1,0,0,1,0,5
2156,2,1,0,0,0,1,0,4
2157,4,0,0,0,0,1,0,5
2158,3,0,0,0,0,1,0,4
2159,4,0,0,0,0,0,0,4
2160,21,1,0,0,0,1,1,24
2161,1,0,0,0,0,1,0,2
2162,4,0,0,0,0,1,0,5
2163,2,0,0,0,0,0,0,2
2164,3,0,0,0,0,1,0,4
2165,2,0,1,0,0,2,0,5
2167,3,0,0,0,0,1,0,4
2168,4,0,0,0,0,1,0,5
2169,4,1,0,0,0,0,0,5
2170,3,1,0,0,0,1,0,5
2171,9,0,0,0,0,0,0,9
2172,4,0,0,0,0,1,0,5
2174,5,0,1,0,0,1,0,7
2175,7,0,0,0,0,0,0,7
2176,3,0,0,0,0,0,1,4
2177,6,0,0,0,0,1,0,7
2178,3,0,0,0,0,0,0,3
2179,3,0,0,0,0,0,0,3
2180,7,0,0,0,0,1,0,8
2181,4,0,0,0,0,0,3,7
2182,1,0,0,0,0,1,0,2
2183,2,0,0,0,0,0,0,2
2184,5,0,1,0,0,1,0,7
2185,3,0,0,0,0,0,0,3
2186,2,0,1,0,0,1,1,5
2187,2,0,0,0,0,0,0,2
2188,4,0,0,0,0,0,0,4
2189,4,0,0,0,0,0,1,5
2190,3,0,1,0,0,1,0,5
2191,3,0,0,0,0,0,0,3
2192,8,0,0,0,0,0,1,9
2193,10,1,0,0,0,1,0,12
2194,5,0,0,0,0,2,0,7
2195,5,0,0,0,0,0,0,5
2196,5,0,0,0,0,0,0,5
2197,7,0,0,0,0,0,0,7
2198,4,0,0,0,0,0,0,4
2199,3,0,0,0,0,0,0,3
2200,11,1,0,0,0,2,0,14
2201,7,0,0,0,0,0,0,7
2202,2,0,0,0,0,1,0,3
2203,5,0,0,0,0,0,0,5
2204,3,0,0,0,0,1,0,4
2205,5,1,1,0,0,1,0,8
2206,3,1,0,0,0,1,0,5
2207,1,0,0,0,0,3,0,4
2208,4,0,0,0,0,0,0,4
2209,2,0,0,0,0,2,0,4
2210,5,0,0,0,0,2,0,7
2211,2,0,0,0,0,0,0,2
2212,6,0,0,0,0,1,0,7
2213,3,0,0,0,0,0,0,3
2214,3,0,0,0,0,0,0,3
2215,1,0,0,0,0,0,0,1
2216,3,0,0,0,0,3,0,6
2217,6,0,0,0,0,0,0,6
2218,5,0,0,0,0,1,0,6
2219,4,0,0,0,0,2,0,6
2220,7,0,0,0,0,0,1,8
2221,3,2,1,0,0,0,1,7
2222,8,0,0,0,0,0,0,8
2223,6,0,0,0,0,0,0,6
2224,5,1,0,0,0,0,0,6
2225,1,0,1,0,0,0,0,2
2226,1,0,0,0,0,3,0,4
2227,9,0,0,0,0,0,0,9
2228,3,0,0,0,0,0,0,3
2229,4,0,0,0,0,2,1,7
2230,5,0,0,0,0,0,0,5
2231,6,0,0,0,0,0,0,6
2232,5,0,1,0,0,1,0,7
2233,9,0,0,0,0,1,0,10
2234,3,0,1,0,0,0,0,4
2235,3,0,0,0,0,1,0,4
2236,2,0,0,0,0,0,0,2
2237,6,0,0,0,0,0,0,6
2238,3,0,0,0,0,0,0,3
2239,6,0,0,0,0,0,0,6
2240,4,0,0,0,0,2,0,6
2241,3,0,0,0,0,0,0,3
2242,0,0,0,0,0,0,1,1
2243,6,0,0,0,0,3,0,9
2244,3,0,0,0,0,0,0,3
2245,3,0,0,0,0,1,0,4
2246,5,0,0,0,0,1,0,6
2247,1,0,0,0,0,0,0,1
2248,4,0,0,0,0,0,1,5
2249,6,0,1,0,0,1,0,8
2250,2,0,0,0,0,0,0,2
2251,2,1,1,0,0,0,1,5
2252,4,0,0,0,0,0,0,4
2253,7,0,0,0,0,2,0,9
2254,2,0,0,0,0,1,1,4
2255,2,0,0,0,0,0,1,3
2256,3,0,0,0,0,1,0,4
2257,1,0,0,0,0,1,0,2
2258,5,0,0,0,0,0,1,6
2259,7,0,0,0,0,0,1,8
2260,6,0,0,0,0,1,0,7
2261,6,0,0,0,0,0,0,6
2262,4,0,0,0,0,2,0,6
2263,1,0,0,0,0,1,0,2
2264,4,0,1,0,0,0,0,5
2265,7,0,0,0,0,1,1,9
2266,4,0,0,0,0,1,0,5
2267,5,0,0,0,0,2,0,7
2268,4,0,0,0,0,1,0,5
2269,2,0,0,0,0,1,0,3
2270,2,0,0,0,0,0,0,2
2271,3,0,1,0,0,2,0,6
2272,3,0,0,0,0,2,0,5
2273,3,0,0,0,0,0,0,3
2274,5,0,0,0,0,0,0,5
2275,5,0,0,0,0,0,0,5
2276,2,0,0,0,0,0,0,2
2277,3,0,0,0,0,0,0,3
2278,3,0,0,0,0,0,0,3
2279,2,0,1,0,0,0,0,3
2280,13,0,1,0,0,1,0,15
2281,2,0,0,0,0,0,0,2
2282,8,1,0,0,0,1,0,10
2283,3,0,0,0,0,0,0,3
2284,2,0,0,0,0,1,0,3
2285,7,1,0,0,0,1,1,10
2286,2,0,1,0,0,0,0,3
2288,7,0,0,0,0,1,0,8
2289,5,0,0,0,0,1,0,6
2290,4,0,0,0,0,0,0,4
2291,3,0,0,0,0,0,0,3
2292,4,0,0,0,0,0,0,4
2293,6,0,0,0,0,0,0,6
2294,3,0,0,0,0,1,0,4
2295,5,0,0,0,0,0,0,5
2296,3,1,0,0,0,0,0,4
2297,6,0,1,0,0,0,0,7
2298,3,0,0,0,0,1,0,4
2299,1,0,0,0,0,0,0,1
2300,5,0,0,0,0,1,0,6
2301,2,0,1,0,0,0,0,3
2302,5,0,0,0,0,2,0,7
2303,3,0,0,0,0,0,1,4
2304,5,0,0,0,0,0,0,5
2305,3,1,0,0,0,0,0,4
2306,5,0,0,0,0,0,1,6
2307,2,0,1,0,0,1,0,4
2308,4,0,0,0,0,3,0,7
2309,3,0,0,0,0,0,0,3
2310,5,0,0,0,0,1,0,6
2311,6,0,0,0,0,0,0,6
2312,3,0,0,0,0,0,0,3
2313,4,0,0,0,0,0,0,4
2314,5,0,0,0,0,0,0,5
2315,4,0,0,0,0,1,0,5
2316,5,0,0,0,0,2,0,7
2317,1,0,0,0,0,0,0,1
2318,5,0,0,0,0,0,0,5
2319,3,0,0,0,0,0,0,3
2320,6,0,2,0,0,2,0,10
2321,6,0,0,0,0,0,0,6
2322,4,0,0,0,0,0,0,4
2323,1,0,0,0,0,0,0,1
2324,2,0,0,0,0,3,0,5
2325,4,0,0,0,0,2,0,6
2326,1,0,0,0,0,0,0,1
2327,5,0,0,0,0,1,0,6
2328,1,0,0,0,0,1,0,2
2329,3,0,0,0,0,0,0,3
2330,3,0,0,0,0,1,0,4
2331,3,0,0,0,0,0,0,3
2332,4,0,0,0,0,2,1,7
2333,1,0,0,0,0,0,0,1
2334,3,0,0,0,0,0,0,3
2335,5,0,0,0,0,0,0,5
2336,6,0,0,0,0,0,0,6
2337,3,0,0,0,0,1,1,5
2338,2,0,1,0,0,0,0,3
2339,6,0,0,0,0,0,0,6
2340,8,1,0,0,0,0,0,9
2341,5,0,0,0,0,0,0,5
2342,4,0,0,0,0,1,0,5
2343,4,0,0,0,0,0,0,4
2344,5,0,0,0,0,0,0,5
2345,7,1,0,0,0,0,0,8
2346,3,0,1,0,0,1,0,5
2347,1,0,1,0,0,0,0,2
2348,6,1,0,0,0,1,0,8
2349,1,0,0,0,0,4,0,5
2350,2,0,0,0,0,0,0,2
2351,3,0,0,0,0,0,0,3
2352,2,0,0,0,0,1,0,3
2353,4,0,1,0,0,0,0,5
2354,3,0,0,0,0,0,0,3
2355,4,0,0,0,0,1,0,5
2356,4,1,0,0,0,1,0,6
2357,2,0,1,0,0,1,0,4
2358,2,0,0,0,0,1,0,3
2359,3,0,0,0,0,1,0,4
2360,12,1,0,0,0,1,1,15
2361,3,0,0,0,0,0,0,3
2362,3,0,0,0,0,0,0,3
2363,0,0,0,0,0,1,0,1
2364,3,0,0,0,0,1,0,4
2365,4,0,0,0,0,2,0,6
2366,2,0,1,0,0,1,0,4
2367,8,0,0,0,0,0,0,8
2368,2,0,0,0,0,1,0,3
2369,3,0,0,0,0,0,0,3
2370,4,0,0,0,0,1,0,5
2371,3,0,0,0,0,0,0,3
2372,6,0,0,0,0,0,0,6
2373,3,0,0,0,0,0,0,3
2374,4,0,0,0,0,1,0,5
2375,1,0,0,0,0,1,0,2
2376,2,0,0,0,0,1,0,3
2377,3,0,1,0,0,0,0,4
2378,1,0,0,0,0,0,0,1
2379,3,0,0,0,0,1,0,4
2380,3,0,1,0,0,0,0,4
2381,4,0,0,0,0,0,0,4
2382,4,0,0,0,0,0,0,4
2383,3,1,0,0,0,1,0,5
2384,1,0,0,0,0,0,0,1
2385,4,0,0,0,0,0,0,4
2386,3,0,1,0,0,0,0,4
2387,2,0,0,0,0,0,0,2
2388,6,0,0,0,0,0,0,6
2389,3,0,0,0,0,0,0,3
2390,6,0,0,0,0,0,0,6
2391,4,0,0,0,0,1,0,5
2392,3,0,0,0,0,0,1,4
2393,2,0,0,0,0,1,0,3
2394,3,0,0,0,0,1,0,4
2395,6,0,0,0,0,0,0,6
2396,3,0,0,0,0,0,0,3
2397,6,0,0,0,0,2,1,9
2398,5,0,0,0,0,0,0,5
2399,3,0,0,0,0,1,0,4
2400,12,0,0,0,0,0,1,13
2401,4,0,0,0,0,0,0,4
2402,5,0,0,0,0,0,0,5
2404,5,0,0,0,0,1,0,6
2405,2,0,0,0,0,1,0,3
2406,3,0,0,0,0,0,0,3
2407,4,0,1,0,0,0,0,5
2408,2,0,0,0,0,2,0,4
2409,2,0,0,0,0,0,0,2
2410,5,0,0,0,0,0,0,5
2411,3,0,0,0,0,0,0,3
2412,2,0,0,0,0,0,1,3
2413,4,0,0,0,0,0,0,4
2414,5,0,0,0,0,0,0,5
2415,5,0,0,0,0,1,0,6
2416,4,0,0,0,0,0,1,5
2417,1,1,0,0,0,0,0,2
2418,3,0,0,0,0,0,1,4
2419,2,0,0,0,0,2,0,4
2420,4,0,0,0,0,1,0,5
2421,2,0,0,0,0,0,0,2
2422,3,0,1,0,0,0,0,4
2423,3,0,0,0,0,1,0,4
2424,2,0,0,0,0,1,0,3
2425,2,0,0,0,0,0,0,2
2426,3,0,0,0,0,0,0,3
2427,3,0,0,0,0,0,0,3
2428,1,0,0,0,0,0,0,1
2429,3,0,0,0,0,0,0,3
2430,5,0,0,0,0,1,0,6
2431,7,0,0,0,0,0,0,7
2432,3,0,0,0,0,0,0,3
2433,3,0,0,0,0,0,0,3
2434,0,0,1,0,0,2,0,3
2435,2,0,0,0,0,1,0,3
2436,2,0,0,0,0,1,1,4
2437,2,0,0,0,0,0,0,2
2438,1,0,0,0,0,0,0,1
2439,4,0,0,0,0,2,0,6
2440,10,0,0,0,0,2,0,12
2441,5,1,0,0,0,0,0,6
2442,1,0,0,0,0,0,0,1
2443,2,0,0,0,0,0,0,2
2444,3,0,0,0,0,0,0,3
2445,2,0,0,0,0,0,0,2
2446,1,0,0,0,0,1,0,2
2447,2,0,0,0,1,0,0,3
2448,2,1,0,0,0,0,0,3
2449,4,1,0,0,0,0,0,5
2450,8,0,1,0,0,0,0,9
2451,2,0,0,0,0,0,0,2
2452,2,0,0,0,0,0,0,2
2453,1,0,0,0,0,0,0,1
2454,4,0,0,0,0,1,0,5
2455,2,0,0,0,0,0,1,3
2456,4,0,0,0,0,1,0,5
2457,2,0,0,0,0,1,0,3
2458,3,0,0,0,0,0,0,3
2459,1,0,0,0,0,0,0,1
2460,6,0,0,0,0,0,1,7
2461,5,0,0,0,0,0,0,5
2462,1,0,0,0,0,0,0,1
2463,3,1,0,0,0,1,0,5
2464,2,0,0,0,0,0,0,2
2465,7,0,0,0,0,0,0,7
2466,3,0,0,0,0,1,0,4
2467,5,0,0,0,0,0,0,5
2468,1,0,3,0,0,0,1,5
2469,4,0,1,0,0,0,0,5
2470,2,0,0,0,0,0,0,2
2471,2,0,0,0,0,2,0,4
2472,4,0,0,0,0,0,0,4
2473,5,0,0,0,0,0,0,5
2474,4,0,0,0,0,1,0,5
2475,4,0,0,0,0,0,0,4
2476,1,0,0,0,0,0,0,1
2477,4,0,0,0,0,2,0,6
2478,3,0,0,0,0,0,0,3
2479,4,1,0,0,0,0,0,5
2480,10,0,0,0,0,1,0,11
2481,2,0,0,0,0,0,0,2
2482,2,0,0,0,0,1,0,3
2483,3,0,0,0,0,0,0,3
2484,2,0,0,0,0,0,0,2
2485,2,0,0,0,0,0,0,2
2486,2,0,0,0,0,0,0,2
2487,1,0,0,0,0,0,0,1
2488,4,0,1,0,0,0,0,5
2489,0,0,0,0,0,1,0,1
2490,2,0,0,0,0,0,0,2
2491,3,0,0,0,0,0,0,3
2492,2,0,0,0,0,0,0,2
2493,2,0,0,0,0,1,0,3
2494,1,0,0,0,0,0,0,1
2495,2,1,0,0,0,2,0,5
2496,5,0,0,0,0,0,0,5
2497,4,0,0,0,0,1,0,5
2498,5,0,0,0,0,2,0,7
2499,3,0,0,0,0,0,0,3
2500,7,0,0,0,0,2,1,10
2501,3,0,0,0,0,0,0,3
2502,3,0,0,0,0,1,0,4
2503,2,0,0,0,0,0,0,2
2504,2,0,0,0,0,1,0,3
2505,5,1,0,0,0,0,0,6
2506,5,0,1,0,0,1,0,7
2507,2,0,0,0,0,0,0,2
2508,2,0,0,0,0,0,0,2
2509,1,0,0,0,0,0,0,1
2510,1,0,0,0,0,0,0,1
2511,3,0,0,0,0,1,0,4
2512,4,0,1,0,0,0,0,5
2513,5,0,0,0,0,0,0,5
2514,3,0,1,0,0,0,0,4
2515,2,0,0,0,0,1,0,3
2516,5,0,0,0,0,0,0,5
2517,3,0,0,0,0,0,0,3
2518,5,0,0,0,0,0,0,5
2519,3,0,0,0,0,2,1,6
2520,9,0,2,0,0,1,0,12
2521,6,0,0,0,0,0,0,6
2522,3,0,1,0,0,0,0,4
2523,5,0,0,0,0,1,1,7
2524,4,0,0,0,0,0,0,4
2525,3,0,0,0,0,0,0,3
2526,1,0,0,0,0,0,0,1
2527,4,0,0,0,0,1,0,5
2528,2,0,0,0,0,0,1,3
2529,2,1,0,0,0,0,0,3
2530,3,0,0,0,0,0,0,3
2531,4,0,0,0,0,1,0,5
2532,1,0,0,0,0,1,0,2
2533,6,0,0,0,0,0,0,6
2534,5,1,0,0,0,1,0,7
2536,0,0,0,0,0,2,0,2
2537,5,0,0,0,0,1,0,6
2538,4,0,0,0,0,0,0,4
2539,1,0,0,0,0,0,0,1
2540,6,1,0,0,0,0,0,7
2541,1,0,0,0,0,0,0,1
2542,2,0,0,0,0,1,0,3
2543,2,1,0,0,0,0,0,3
2544,3,0,0,0,0,0,0,3
2545,1,0,0,0,0,0,0,1
2546,2,0,0,0,0,1,0,3
2547,4,0,0,0,0,0,0,4
2548,1,0,0,0,0,0,0,1
2549,2,0,0,0,0,0,0,2
2550,4,0,0,0,0,0,0,4
2551,2,0,0,0,0,0,0,2
2552,1,0,0,0,0,0,0,1
2553,1,0,0,0,0,0,0,1
2554,8,1,0,0,0,1,0,10
2555,3,0,0,0,0,0,0,3
2556,4,0,0,0,0,1,0,5
2557,1,0,0,0,0,0,0,1
2558,3,0,0,0,0,1,0,4
2559,2,0,0,0,0,0,0,2
2560,10,0,0,0,0,0,0,10
2561,3,0,0,0,0,0,0,3
2562,2,0,0,0,0,1,0,3
2563,2,0,0,0,0,1,0,3
2564,5,0,0,0,0,0,0,5
2566,1,0,0,0,0,0,0,1
2567,2,0,0,0,0,0,0,2
2568,3,0,0,0,0,0,0,3
2569,1,0,0,0,0,0,0,1
2570,2,0,0,0,0,0,0,2
2572,4,0,1,0,0,1,1,7
2575,6,0,0,0,0,1,0,7
2576,4,0,0,0,0,0,0,4
2577,3,0,0,0,0,1,0,4
2578,2,0,0,0,0,0,0,2
2579,2,0,1,0,0,0,0,3
2580,5,0,0,0,1,0,0,6
2581,1,0,0,0,0,0,0,1
2582,1,0,0,0,0,2,0,3
2583,3,0,0,0,0,0,0,3
2584,2,0,0,0,0,0,0,2
2585,4,0,0,0,0,0,0,4
2586,5,0,0,0,0,0,0,5
2587,3,1,0,0,0,1,1,6
2588,4,0,0,0,0,0,0,4
2589,3,0,0,0,0,0,0,3
2590,4,0,0,0,0,1,0,5
2591,2,0,0,0,0,0,2,4
2592,2,0,0,0,0,1,0,3
2593,1,1,0,0,0,0,0,2
2595,4,0,0,0,0,0,0,4
2596,1,0,0,0,0,0,0,1
2597,1,0,1,0,0,0,0,2
2598,2,1,0,0,0,0,0,3
2599,2,0,0,0,0,0,0,2
2600,4,1,0,0,0,0,0,5
2601,2,0,0,0,0,0,0,2
2602,0,0,1,0,0,0,0,1
2603,4,0,0,0,0,0,0,4
2604,1,0,0,0,0,1,0,2
2605,3,0,0,0,0,1,0,4
2606,1,0,1,0,0,3,0,5
2607,3,0,0,0,0,0,0,3
2608,3,0,0,0,0,1,0,4
2609,3,0,0,0,0,1,0,4
2610,2,0,0,0,0,0,0,2
2611,0,0,1,0,0,0,0,1
2612,6,0,0,0,0,0,0,6
2613,2,0,0,0,0,0,0,2
2615,3,0,0,0,0,0,0,3
2616,2,0,0,0,0,1,0,3
2617,3,0,0,0,0,0,1,4
2618,1,0,0,0,0,0,0,1
2619,4,0,0,0,0,2,0,6
2620,6,0,0,0,0,1,0,7
2621,3,1,0,0,0,1,1,6
2622,4,0,0,0,0,0,0,4
2623,4,0,0,0,0,1,0,5
2624,0,0,1,0,0,0,0,1
2625,4,0,0,0,0,0,0,4
2626,1,0,0,0,0,1,0,2
2627,10,1,1,0,0,2,0,14
2628,3,0,1,0,0,0,0,4
2629,5,0,0,0,0,1,0,6
2630,3,0,0,0,0,0,0,3
2631,2,0,0,0,0,0,0,2
2632,5,0,0,0,0,0,0,5
2633,1,0,0,0,0,1,0,2
2634,4,0,0,0,0,1,0,5
2635,3,0,0,0,0,0,0,3
2636,3,1,0,0,0,2,0,6
2637,1,0,0,0,0,0,0,1
2638,1,0,0,0,0,0,0,1
2640,14,2,1,0,0,0,0,17
2641,1,0,0,0,1,0,0,2
2642,2,0,0,0,0,1,0,3
2643,2,1,0,0,0,0,0,3
2644,2,0,0,0,0,0,0,2
2645,5,0,0,0,0,0,0,5
2646,2,0,0,0,0,0,0,2
2647,5,0,0,0,0,0,0,5
2648,0,0,1,0,0,0,0,1
2649,3,0,0,0,0,0,0,3
2650,2,0,0,0,0,0,0,2
2651,7,1,0,0,0,0,0,8
2652,3,0,1,0,0,0,0,4
2653,4,0,0,0,0,0,0,4
2654,2,1,0,0,0,0,0,3
2655,1,0,0,0,0,0,0,1
2656,7,0,0,0,0,0,0,7
2657,2,0,0,0,0,1,0,3
2658,2,0,0,0,0,1,0,3
2659,3,0,0,0,0,0,0,3
2661,1,0,1,0,0,0,0,2
2662,4,0,0,0,0,0,0,4
2665,3,0,0,0,0,2,0,5
2666,4,0,0,0,0,0,0,4
2668,2,0,0,0,0,1,0,3
2669,4,0,1,0,0,0,0,5
2670,3,0,0,0,0,0,0,3
2671,3,0,0,0,0,2,0,5
2672,4,0,0,0,0,0,0,4
2673,3,0,0,0,0,0,0,3
2674,2,0,0,0,0,0,0,2
2675,2,0,0,0,0,0,0,2
2676,1,0,0,0,0,0,0,1
2677,2,0,0,0,0,0,0,2
2678,3,0,0,0,0,0,0,3
2679,0,0,0,0,0,2,0,2
2680,11,0,1,0,0,1,0,13
2681,4,0,0,0,0,0,0,4
2682,2,0,0,0,0,0,0,2
2683,4,0,0,0,0,1,0,5
2684,1,0,0,0,0,0,0,1
2685,3,0,0,0,0,1,0,4
2686,0,0,0,0,0,1,0,1
2687,1,0,0,0,0,0,0,1
2688,4,0,0,0,0,1,0,5
2690,3,1,0,0,0,0,0,4
2691,3,0,0,0,0,2,0,5
2693,5,0,0,0,0,0,0,5
2694,3,0,0,0,0,0,0,3
2695,2,0,0,0,0,0,0,2
2696,4,0,0,0,0,1,0,5
2697,5,0,0,0,0,0,0,5
2698,2,0,0,0,0,0,0,2
2699,1,0,0,0,0,1,0,2
2700,2,0,1,0,0,0,0,3
2701,5,0,0,0,0,0,0,5
2702,3,0,0,0,0,0,0,3
2703,2,0,0,0,0,0,0,2
2704,2,0,0,0,0,1,0,3
2705,2,1,0,0,0,0,0,3
2707,3,0,0,0,0,0,0,3
2708,2,0,0,0,0,0,0,2
2709,2,0,0,0,0,0,0,2
2710,1,0,0,0,0,0,0,1
2711,5,0,0,0,0,1,0,6
2712,3,0,0,0,0,0,0,3
2713,3,0,0,0,0,0,0,3
2714,4,0,0,0,0,0,0,4
2715,5,0,0,0,0,0,0,5
2716,3,0,0,0,0,0,0,3
2717,1,0,0,0,0,0,0,1
2718,1,0,0,0,0,0,0,1
2719,1,0,0,0,0,1,0,2
2720,13,3,1,0,0,0,1,18
2721,2,0,0,0,0,0,0,2
2722,1,0,0,0,0,0,0,1
2723,1,1,1,0,0,0,0,3
2724,2,0,1,0,0,0,0,3
2725,3,1,0,0,0,0,0,4
2726,3,0,0,0,0,0,0,3
2727,5,0,0,0,0,0,0,5
2728,5,0,0,0,0,0,0,5
2729,1,0,0,0,0,1,0,2
2730,3,0,0,0,0,0,0,3
2731,2,0,0,0,0,0,0,2
2732,6,0,0,0,0,1,0,7
2733,2,0,0,0,0,0,0,2
2734,4,0,0,0,0,0,0,4
2735,4,1,0,0,0,0,0,5
2736,3,0,0,0,0,0,0,3
2737,1,0,1,0,0,0,0,2
2739,1,0,0,0,0,0,0,1
2740,4,0,0,0,0,1,0,5
2741,2,0,0,0,0,0,0,2
2742,1,0,0,0,0,0,0,1
2743,2,0,0,0,0,0,0,2
2745,2,0,0,0,0,0,0,2
2747,3,0,0,0,0,1,0,4
2749,2,0,0,0,0,0,0,2
2750,3,0,0,0,0,0,0,3
2752,1,0,0,0,0,0,0,1
2753,2,0,0,0,0,0,0,2
2755,2,0,0,0,0,0,0,2
2756,3,0,0,0,0,0,1,4
2757,6,0,0,0,0,0,0,6
2758,3,0,0,0,0,1,0,4
2759,1,0,1,0,0,0,0,2
2760,3,0,2,0,0,4,0,9
2762,1,0,0,0,0,1,0,2
2763,3,0,0,0,0,1,0,4
2764,0,0,0,0,0,0,1,1
2765,1,0,0,0,0,1,0,2
2766,4,0,0,0,0,1,0,5
2767,3,0,0,0,0,0,0,3
2768,2,1,0,0,0,0,0,3
2769,1,0,0,0,0,0,0,1
2770,4,0,0,0,0,0,0,4
2771,2,0,1,0,0,2,1,6
2772,3,0,0,0,0,0,0,3
2773,0,0,0,0,0,1,0,1
2774,3,0,0,0,0,0,0,3
2775,4,0,0,0,0,0,0,4
2776,2,0,0,0,0,0,0,2
2777,3,0,0,0,0,0,0,3
2778,2,1,0,0,0,0,0,3
2779,2,0,0,0,0,2,0,4
2781,3,0,0,0,0,0,0,3
2782,2,0,0,0,0,0,0,2
2783,5,1,0,0,0,1,0,7
2784,2,0,0,0,0,0,0,2
2785,1,0,0,0,0,0,0,1
2786,6,0,0,0,0,0,0,6
2787,2,0,0,0,0,0,0,2
2788,3,0,0,0,0,0,0,3
2790,1,0,0,0,0,0,0,1
2792,5,0,0,0,0,0,0,5
2793,2,0,0,0,0,0,0,2
2795,1,0,0,0,0,0,0,1
2796,3,0,0,0,0,1,0,4
2797,1,0,0,0,0,0,0,1
2798,2,1,1,0,0,0,0,4
2799,2,0,0,0,0,0,0,2
2800,4,0,1,0,0,1,0,6
2801,4,0,0,0,0,0,0,4
2802,3,0,0,0,0,0,0,3
2803,3,0,0,0,0,0,0,3
2804,3,0,0,0,0,2,0,5
2805,1,0,0,0,0,0,0,1
2806,2,1,0,0,0,0,0,3
2807,1,0,0,0,0,0,0,1
2808,3,0,0,0,0,0,1,4
2809,2,0,0,0,0,0,0,2
2810,2,0,0,0,0,1,0,3
2811,3,0,0,0,0,0,0,3
2812,4,0,0,0,0,1,0,5
2813,4,0,0,0,0,0,1,5
2814,5,0,0,0,0,0,0,5
2815,2,0,0,0,0,0,0,2
2816,3,0,0,0,0,0,0,3
2817,1,0,0,0,0,0,0,1
2819,6,0,0,0,0,0,0,6
2820,4,0,0,0,0,0,0,4
2822,4,0,0,0,0,0,0,4
2823,4,1,0,0,0,1,0,6
2824,1,0,0,0,0,1,0,2
2825,1,0,0,0,0,1,0,2
2826,3,0,0,0,0,0,0,3
2827,2,0,1,0,0,0,0,3
2828,4,0,0,0,0,0,0,4
2829,5,0,0,0,0,0,0,5
2830,2,0,0,0,0,1,0,3
2831,4,0,0,0,0,0,0,4
2832,1,0,0,0,0,0,0,1
2833,0,1,0,0,0,1,0,2
2834,4,0,0,0,0,0,0,4
2835,3,0,0,0,0,0,0,3
2836,5,0,0,0,0,0,0,5
2837,1,0,0,0,0,0,0,1
2838,0,1,0,0,0,0,0,1
2839,3,0,0,0,0,0,0,3
2840,8,0,1,0,0,0,0,9
2841,4,0,0,0,0,0,0,4
2842,1,0,0,0,0,0,0,1
2843,0,0,0,0,0,1,0,1
2844,2,0,0,0,0,0,0,2
2845,1,0,0,0,0,0,0,1
2846,4,0,0,0,0,0,0,4
2847,3,0,0,0,0,0,0,3
2848,4,0,0,0,0,0,0,4
2849,2,0,0,0,0,0,0,2
2850,4,0,0,0,0,0,0,4
2851,3,0,0,0,0,0,0,3
2852,3,0,0,0,0,0,0,3
2854,6,0,0,0,0,0,0,6
2855,1,0,0,0,0,0,0,1
2856,2,0,1,0,0,0,0,3
2857,1,0,0,0,0,0,0,1
2859,1,0,0,0,0,0,0,1
2860,2,0,0,0,0,1,0,3
2861,2,0,0,0,0,0,0,2
2862,3,1,0,0,0,1,0,5
2863,1,0,0,0,0,0,0,1
2864,6,0,2,0,0,1,0,9
2865,4,0,1,0,0,0,0,5
2866,5,0,0,0,0,0,0,5
2867,0,0,0,0,0,1,0,1
2868,3,0,0,0,0,0,0,3
2869,1,0,1,0,0,0,0,2
2870,2,0,0,0,0,0,0,2
2871,1,0,0,0,0,1,0,2
2872,2,0,0,0,0,0,0,2
2873,2,0,0,0,0,0,0,2
2874,0,1,0,0,0,0,0,1
2875,3,0,0,0,0,2,0,5
2876,2,1,0,0,0,0,1,4
2878,1,0,0,0,0,1,0,2
2879,2,0,0,0,0,0,0,2
2880,14,1,1,0,0,0,0,16
2881,3,0,0,0,0,0,0,3
2882,1,0,0,0,0,0,0,1
2883,1,0,0,0,0,0,0,1
2884,5,0,0,0,0,2,0,7
2885,3,0,1,0,0,0,0,4
2886,5,0,0,0,0,0,0,5
2887,2,0,1,0,0,0,0,3
2888,1,0,0,0,0,0,0,1
2889,2,0,0,0,0,0,0,2
2890,0,1,1,0,0,0,0,2
2891,4,0,0,0,0,0,0,4
2892,4,0,0,0,0,0,0,4
2893,2,0,0,0,0,0,0,2
2894,2,0,0,0,0,0,0,2
2895,2,0,0,0,0,0,0,2
2896,1,0,0,0,0,0,0,1
2897,0,0,0,0,0,0,1,1
2898,6,1,0,0,0,1,0,8
2899,4,0,0,0,0,1,0,5
2900,2,0,0,0,0,0,0,2
2902,2,0,0,0,0,1,0,3
2903,2,0,0,0,0,0,0,2
2904,1,0,0,0,0,0,0,1
2905,0,0,0,0,0,1,0,1
2906,3,0,0,0,0,1,0,4
2907,2,0,0,0,0,0,0,2
2908,4,0,0,0,0,0,0,4
2909,2,0,0,0,0,0,0,2
2910,0,0,1,0,0,1,0,2
2911,1,0,0,0,0,1,0,2
2912,2,0,0,0,0,0,0,2
2913,3,0,0,0,0,0,0,3
2914,2,0,0,0,0,1,0,3
2915,5,0,0,0,0,0,0,5
2916,1,0,0,0,0,0,0,1
2917,3,0,0,0,0,1,0,4
2919,3,0,0,0,0,0,0,3
2920,8,0,1,0,0,0,0,9
2921,2,0,0,0,0,0,0,2
2922,3,0,0,0,0,0,1,4
2923,3,0,0,0,0,0,0,3
2924,3,0,0,0,0,1,0,4
2925,3,0,0,0,0,0,0,3
2926,2,0,0,0,0,0,0,2
2927,4,0,0,0,0,0,0,4
2928,3,0,0,0,0,0,0,3
2929,2,0,0,0,0,0,0,2
2930,4,0,0,0,0,0,0,4
2931,3,0,0,0,0,0,0,3
2933,4,0,0,0,0,0,0,4
2934,2,0,0,0,0,0,0,2
2935,2,0,0,0,0,0,0,2
2936,2,1,0,0,0,1,0,4
2937,2,0,0,0,0,0,0,2
2938,3,0,0,0,0,0,0,3
2940,3,0,0,0,0,0,0,3
2941,1,0,0,0,0,0,0,1
2942,3,0,0,0,0,0,0,3
2943,2,0,0,0,0,0,0,2
2944,3,0,0,0,0,0,0,3
2945,2,0,0,0,0,0,0,2
2946,2,0,0,0,0,0,0,2
2947,3,0,0,0,0,0,0,3
2948,1,0,0,0,0,0,0,1
2949,0,0,0,0,0,1,0,1
2950,1,0,0,0,0,0,0,1
2952,0,0,1,0,0,0,0,1
2953,2,0,0,0,0,0,0,2
2954,3,0,1,0,0,2,0,6
2955,1,0,0,0,0,0,0,1
2957,2,0,0,0,0,0,0,2
2958,2,0,1,0,0,0,0,3
2959,3,0,0,0,0,0,0,3
2960,9,0,1,0,0,1,0,11
2962,1,0,0,0,0,1,0,2
2963,1,0,0,0,0,0,0,1
2964,3,0,0,0,0,0,0,3
2966,3,0,0,0,0,0,0,3
2967,3,0,0,0,0,0,0,3
2969,2,0,0,0,0,0,0,2
2970,2,0,0,0,0,0,0,2
2971,2,0,0,0,0,1,0,3
2972,2,0,0,0,0,0,0,2
2974,0,0,1,0,0,0,0,1
2975,1,1,0,0,0,0,0,2
2976,2,0,0,0,0,0,0,2
2977,5,0,0,0,0,0,1,6
2978,4,1,1,0,0,0,0,6
2979,2,0,0,0,0,0,0,2
2980,2,0,0,0,0,1,0,3
2981,3,0,1,0,0,0,0,4
2982,0,0,0,0,0,0,1,1
2984,3,1,0,0,0,0,0,4
2985,6,0,0,0,0,1,0,7
2986,2,0,0,0,0,0,0,2
2987,0,0,0,0,0,1,0,1
2989,3,0,0,0,0,0,0,3
2991,3,0,0,0,0,0,0,3
2992,1,0,0,0,0,0,0,1
2993,1,0,0,0,0,1,0,2
2994,1,0,0,0,0,1,0,2
2995,4,0,0,0,0,0,0,4
2996,1,0,0,0,0,0,0,1
2997,1,0,0,0,0,0,0,1
2998,2,0,0,0,0,1,0,3
3000,9,0,1,0,0,1,0,11
3001,1,0,0,0,0,0,0,1
3002,1,0,0,0,0,1,0,2
3003,4,0,0,0,0,0,0,4
3004,2,0,0,0,0,0,0,2
3005,1,0,0,0,0,0,0,1
3006,3,0,0,0,0,0,0,3
3007,2,1,0,0,0,0,0,3
3008,2,0,0,0,0,0,0,2
3009,3,0,0,0,0,0,0,3
3010,1,0,0,0,0,0,0,1
3011,4,0,1,0,0,0,0,5
3012,4,0,0,0,0,0,0,4
3013,1,0,0,0,0,0,0,1
3014,3,0,0,0,0,2,0,5
3015,1,0,0,0,0,0,0,1
3016,2,0,0,0,0,0,0,2
3017,2,0,0,0,0,0,0,2
3018,3,0,0,0,0,0,0,3
3019,5,0,0,0,0,1,0,6
3020,2,0,0,0,0,0,0,2
3021,2,0,0,0,0,0,0,2
3022,2,1,0,0,0,0,0,3
3023,1,0,0,0,0,0,0,1
3026,2,1,0,0,0,0,0,3
3027,3,0,0,0,0,0,0,3
3028,3,0,0,0,0,1,0,4
3029,1,0,0,0,0,0,0,1
3030,1,0,0,0,0,0,0,1
3031,5,0,0,0,0,0,0,5
3032,4,0,0,0,0,0,0,4
3033,0,0,0,0,0,1,0,1
3034,1,0,1,0,0,0,0,2
3035,1,0,0,0,0,0,0,1
3037,1,0,0,0,0,0,0,1
3038,1,0,0,0,0,1,0,2
3039,5,0,0,0,0,0,0,5
3040,9,1,0,0,0,1,0,11
3041,2,0,0,0,0,3,0,5
3042,2,0,0,0,0,0,0,2
3043,2,0,0,0,0,0,0,2
3044,4,0,0,0,0,1,0,5
3045,3,0,0,0,0,0,0,3
3046,3,0,0,0,0,0,0,3
3048,3,0,1,0,0,0,0,4
3049,2,0,0,0,0,0,0,2
3050,1,0,1,0,0,0,0,2
3051,3,0,0,0,0,0,0,3
3052,3,0,0,0,0,0,0,3
3053,4,0,0,0,0,0,0,4
3054,1,1,0,0,0,0,0,2
3055,2,0,1,0,0,0,0,3
3056,2,0,0,0,0,0,0,2
3057,1,0,0,0,0,0,0,1
3058,1,0,0,0,0,0,0,1
3059,1,0,0,0,0,0,0,1
3060,1,0,0,0,0,0,0,1
3061,1,0,0,0,0,0,1,2
3062,3,0,0,0,0,0,0,3
3063,3,0,0,0,0,0,0,3
3066,1,0,0,0,0,0,0,1
3067,1,0,0,0,0,0,0,1
3068,1,0,0,0,0,0,0,1
3069,1,0,0,0,0,0,0,1
3072,3,0,0,0,0,0,0,3
3073,3,0,0,0,0,0,0,3
3074,1,0,0,0,0,1,0,2
3075,2,0,0,0,0,0,0,2
3076,2,0,0,0,0,0,0,2
3077,1,0,0,0,0,0,0,1
3078,1,0,0,0,0,0,0,1
3079,2,0,0,0,0,0,0,2
3080,6,0,0,0,0,0,0,6
3081,2,0,0,0,0,0,0,2
3082,2,0,0,0,0,0,0,2
3084,2,0,0,0,1,0,0,3
3085,2,1,0,0,0,1,0,4
3086,2,0,0,0,0,0,0,2
3087,3,0,0,0,0,0,0,3
3088,1,0,0,0,0,0,0,1
3089,3,0,0,0,0,0,0,3
3090,3,0,1,0,0,0,0,4
3093,0,1,0,0,0,0,0,1
3094,2,0,0,0,0,0,0,2
3095,3,0,1,0,0,0,0,4
3096,1,1,0,0,0,1,1,4
3097,1,0,0,0,0,0,0,1
3099,1,1,0,0,0,0,0,2
3100,1,0,1,0,0,0,0,2
3101,2,0,0,0,0,0,0,2
3102,1,0,0,0,0,0,0,1
3103,3,0,0,0,0,0,0,3
3104,3,1,0,0,0,0,0,4
3106,1,0,0,0,0,0,0,1
3109,2,0,0,0,0,0,0,2
3110,3,0,0,0,0,0,0,3
3111,2,1,0,0,0,0,0,3
3112,0,0,1,0,0,0,0,1
3113,0,0,1,0,0,0,0,1
3114,1,0,0,0,0,0,0,1
3115,5,0,0,0,0,0,0,5
3116,2,0,0,0,0,0,0,2
3117,5,0,0,0,0,0,0,5
3118,1,0,0,0,0,0,0,1
3119,1,0,0,0,0,0,0,1
3120,14,1,1,0,0,3,0,19
3121,4,0,0,0,0,1,0,5
3122,1,0,0,0,0,0,0,1
3123,1,0,0,0,0,0,0,1
3125,1,0,1,0,0,1,0,3
3126,3,1,0,0,0,0,0,4
3127,2,0,0,0,0,0,0,2
3128,3,0,0,0,0,0,0,3
3131,2,1,0,0,0,0,0,3
3132,2,0,1,0,0,0,0,3
3133,2,0,0,0,0,0,0,2
3134,1,0,0,0,0,0,0,1
3135,1,0,0,0,0,0,0,1
3136,1,0,0,0,0,0,0,1
3137,4,0,0,0,0,0,0,4
3138,5,0,0,0,0,0,0,5
3141,2,0,0,0,0,0,0,2
3142,2,0,0,0,0,0,1,3
3143,2,0,0,0,0,0,0,2
3144,3,0,0,0,0,0,0,3
3145,1,0,0,0,0,0,0,1
3146,3,0,1,0,0,0,0,4
3149,2,0,0,0,0,0,0,2
3150,4,0,1,0,0,0,1,6
3151,1,0,0,0,0,0,0,1
3152,1,0,1,0,0,1,0,3
3153,2,0,0,0,0,0,0,2
3154,3,0,1,0,0,0,0,4
3155,2,0,0,0,0,0,1,3
3157,2,0,0,0,0,0,0,2
3158,1,0,0,0,0,0,0,1
3160,2,1,0,0,0,0,0,3
3161,1,0,0,0,0,0,0,1
3162,3,0,0,0,0,1,0,4
3163,1,0,0,0,0,1,0,2
3164,0,0,0,0,0,1,0,1
3165,3,0,0,0,0,1,0,4
3166,1,0,0,0,0,0,0,1
3167,2,0,1,0,0,0,0,3
3168,1,0,1,0,0,0,0,2
3169,2,0,0,0,0,0,0,2
3170,1,0,0,0,0,0,0,1
3172,2,0,0,0,0,0,0,2
3173,2,0,0,0,0,0,0,2
3174,3,0,0,0,0,0,0,3
3175,1,0,0,0,0,1,0,2
3176,1,0,0,0,0,0,0,1
3178,2,0,0,0,0,0,0,2
3179,3,0,0,0,0,0,0,3
3180,3,1,0,0,0,1,0,5
3181,2,0,0,0,0,0,0,2
3182,0,0,0,0,0,1,0,1
3183,3,0,0,0,0,0,0,3
3184,2,0,0,0,0,0,0,2
3185,2,0,0,0,0,0,0,2
3186,2,0,0,0,0,0,0,2
3189,2,0,0,0,0,0,0,2
3190,2,0,0,0,0,0,0,2
3191,3,0,0,0,0,0,0,3
3192,3,0,0,0,0,0,0,3
3195,5,0,0,0,0,0,0,5
3196,1,0,0,0,0,0,0,1
3197,2,0,0,0,0,1,0,3
3199,0,0,0,0,0,1,0,1
3200,6,1,0,0,0,0,0,7
3201,1,0,0,0,0,0,0,1
3202,2,0,1,0,0,0,0,3
3203,1,0,0,0,0,1,0,2
3204,1,1,0,0,0,0,0,2
3205,3,0,0,0,0,0,0,3
3206,1,0,0,0,0,0,0,1
3207,0,0,0,0,0,1,0,1
3209,1,0,0,0,0,0,0,1
3210,2,0,0,0,0,0,0,2
3211,1,0,0,0,0,0,0,1
3212,3,0,0,0,0,0,0,3
3215,3,0,0,0,0,1,0,4
3216,1,0,0,0,0,0,0,1
3218,4,0,0,0,0,0,0,4
3219,1,0,0,0,0,0,0,1
3221,2,0,0,0,0,0,0,2
3222,1,0,0,0,0,0,0,1
3223,1,0,0,0,0,0,0,1
3224,1,0,0,0,0,0,0,1
3225,1,0,0,0,0,1,0,2
3226,1,0,0,0,0,0,0,1
3227,3,0,0,0,0,0,0,3
3228,1,0,0,0,0,1,0,2
3229,1,0,0,0,0,0,0,1
3230,1,0,0,0,0,0,0,1
3231,0,0,0,0,0,1,0,1
3232,2,0,0,0,0,0,0,2
3233,1,0,0,0,0,0,0,1
3235,4,0,0,0,0,0,0,4
3236,4,0,0,0,0,0,0,4
3237,2,0,0,0,0,0,0,2
3238,2,0,0,0,0,0,0,2
3239,1,0,0,0,0,0,0,1
3240,7,0,0,0,0,1,0,8
3241,3,0,1,0,0,0,0,4
3243,2,0,0,0,0,0,0,2
3244,5,0,0,0,0,1,0,6
3245,2,0,0,0,0,0,0,2
3246,1,0,0,0,0,0,0,1
3247,1,0,0,0,0,0,0,1
3249,0,0,1,0,0,0,0,1
3250,2,0,0,0,0,0,0,2
3251,2,0,1,0,0,0,0,3
3253,2,0,0,0,0,0,0,2
3254,1,0,0,0,0,0,0,1
3255,1,0,0,0,0,0,0,1
3257,0,0,0,0,0,1,0,1
3258,1,0,0,0,0,0,0,1
3259,1,0,0,0,0,0,0,1
3260,4,0,0,0,0,0,0,4
3261,3,0,0,0,0,0,0,3
3262,1,0,0,0,0,0,0,1
3263,2,0,0,0,0,1,0,3
3264,2,0,0,0,0,0,0,2
3266,2,0,1,0,0,0,0,3
3267,1,0,0,0,0,0,0,1
3268,1,0,1,0,0,0,0,2
3269,5,0,0,0,0,0,0,5
3273,3,0,0,0,0,0,0,3
3274,5,0,0,0,0,0,0,5
3275,1,0,0,0,0,0,0,1
3276,1,0,0,0,0,0,0,1
3277,2,0,1,0,0,1,0,4
3278,1,0,0,0,0,0,0,1
3279,2,0,0,0,0,0,0,2
3280,4,0,1,0,0,0,0,5
3281,2,0,0,0,0,0,0,2
3282,3,0,0,0,0,0,0,3
3283,1,0,0,0,0,0,0,1
3284,1,0,0,0,0,0,0,1
3286,1,1,0,0,0,0,0,2
3287,1,0,0,0,0,0,0,1
3289,2,0,0,0,0,0,0,2
3291,3,0,1,0,0,0,0,4
3292,4,0,0,0,0,0,1,5
3293,1,0,0,0,0,0,0,1
3294,3,0,0,0,0,0,0,3
3295,3,0,0,0,0,0,0,3
3297,2,0,0,0,0,0,0,2
3298,2,0,0,0,0,0,0,2
3300,2,0,0,0,0,0,0,2
3301,2,1,0,0,0,0,0,3
3302,2,0,0,0,0,0,0,2
3303,2,0,0,0,0,0,0,2
3304,2,0,0,0,0,0,0,2
3305,1,0,1,0,0,0,0,2
3306,2,0,0,0,0,0,0,2
3307,2,0,0,0,0,0,0,2
3308,3,0,0,0,0,0,0,3
3309,1,0,0,0,0,1,0,2
3310,2,0,0,0,0,0,0,2
3312,3,0,0,0,0,0,0,3
3313,1,0,0,0,0,0,0,1
3314,3,0,0,0,0,0,0,3
3315,0,0,0,0,0,1,0,1
3316,1,0,0,0,0,0,0,1
3317,3,0,0,0,0,0,0,3
3319,3,0,0,0,0,1,1,5
3320,5,0,0,0,0,0,0,5
3322,1,0,0,0,0,0,0,1
3323,3,0,0,0,0,0,0,3
3324,2,0,0,0,0,0,0,2
3325,2,0,0,0,0,0,0,2
3326,3,0,0,0,0,0,0,3
3327,2,0,0,0,0,0,0,2
3328,1,0,0,0,0,0,0,1
3329,4,0,0,0,0,1,0,5
3330,1,0,0,0,0,0,0,1
3331,1,0,0,0,0,0,0,1
3333,4,0,0,0,0,0,0,4
3334,2,0,0,0,0,0,0,2
3337,1,2,0,0,0,0,0,3
3338,0,0,1,0,0,0,0,1
3339,1,0,0,0,0,1,0,2
3340,0,0,0,0,0,1,0,1
3341,1,0,0,0,0,0,0,1
3343,2,0,0,0,0,0,0,2
3345,3,0,1,0,0,0,0,4
3346,1,0,0,0,0,0,1,2
3347,3,0,0,0,0,0,0,3
3348,0,0,0,0,0,0,1,1
3349,0,0,0,0,0,1,0,1
3350,2,0,0,0,0,0,0,2
3351,2,0,0,0,0,0,0,2
3352,1,0,0,0,0,0,0,1
3353,1,0,0,0,0,0,0,1
3354,2,0,0,0,1,0,0,3
3355,1,0,0,0,0,1,0,2
3356,1,0,0,0,0,0,0,1
3357,1,1,0,0,0,0,0,2
3358,1,0,0,0,0,1,1,3
3359,1,0,0,0,0,0,0,1
3360,16,1,4,0,0,2,1,24
3361,2,0,0,0,0,0,0,2
3362,1,0,0,0,0,1,0,2
3364,4,0,0,0,0,0,0,4
3366,1,0,0,0,0,0,0,1
3367,3,0,0,0,0,1,0,4
3368,1,0,0,0,0,0,0,1
3371,1,0,0,0,0,1,0,2
3372,2,0,0,0,0,0,0,2
3374,0,0,0,0,0,1,0,1
3375,1,0,0,0,0,0,0,1
3376,2,0,0,0,0,0,0,2
3377,1,0,0,0,0,0,0,1
3379,3,0,0,0,0,0,0,3
3380,1,0,0,0,0,0,0,1
3382,1,0,0,0,0,0,0,1
3383,3,0,0,0,0,0,0,3
3384,3,0,1,0,0,0,0,4
3385,1,0,0,0,0,0,0,1
3386,1,0,0,0,0,0,0,1
3391,2,0,0,0,0,0,0,2
3392,4,0,0,0,0,0,0,4
3393,2,0,0,0,0,0,0,2
3394,0,1,0,0,0,0,0,1
3395,1,0,0,0,0,0,0,1
3396,1,0,0,0,0,0,0,1
3397,1,0,0,0,0,0,0,1
3398,2,0,0,0,0,0,0,2
3400,7,0,0,0,0,2,2,11
3401,1,0,0,0,0,0,0,1
3402,1,0,0,0,0,1,0,2
3403,1,0,0,0,0,0,0,1
3405,2,0,0,0,0,0,0,2
3407,1,0,0,0,0,0,0,1
3409,3,0,0,0,0,0,0,3
3410,4,0,0,0,0,1,0,5
3411,1,0,0,0,0,0,0,1
3412,1,0,0,0,0,0,0,1
3414,2,0,0,0,0,0,0,2
3415,2,0,0,0,0,0,0,2
3416,3,0,0,0,0,1,0,4
3418,3,0,1,0,0,0,0,4
3420,1,0,0,0,0,0,1,2
3421,1,0,0,0,0,0,0,1
3422,3,0,0,0,0,0,0,3
3423,2,0,0,0,0,0,0,2
3424,3,0,0,0,0,0,0,3
3425,1,0,1,0,0,0,0,2
3426,3,0,0,0,0,0,0,3
3427,2,0,0,0,0,0,0,2
3428,3,0,0,0,0,0,0,3
3429,4,0,0,0,0,0,0,4
3430,2,0,0,0,0,0,0,2
3431,3,0,0,0,0,0,0,3
3432,2,0,0,0,0,0,0,2
3433,0,0,1,0,0,0,0,1
3434,2,0,0,0,0,1,0,3
3435,2,0,0,0,0,1,0,3
3436,2,0,0,0,0,0,0,2
3437,1,0,0,0,0,0,0,1
3438,1,0,0,0,0,0,0,1
3440,11,0,1,0,0,0,0,12
3441,1,0,0,0,0,0,0,1
3442,1,0,1,0,0,0,0,2
3443,2,0,0,0,0,0,0,2
3444,3,0,0,0,0,0,0,3
3445,0,0,0,0,0,2,0,2
3446,0,0,1,0,0,0,0,1
3449,1,0,0,0,0,0,0,1
3450,2,0,1,0,0,0,0,3
3451,3,0,0,0,0,0,0,3
3453,1,0,0,0,0,0,0,1
3454,3,0,0,0,0,1,0,4
3455,2,0,1,0,0,0,0,3
3456,1,0,0,0,1,0,1,3
3457,2,0,0,0,0,1,0,3
3460,2,0,0,0,0,0,0,2
3462,1,0,0,0,0,0,0,1
3463,1,0,0,0,0,0,0,1
3465,3,0,0,0,0,0,0,3
3468,2,0,0,0,0,0,0,2
3469,1,0,0,0,0,1,0,2
3470,1,0,0,0,0,0,0,1
3471,0,0,0,0,0,1,0,1
3472,0,0,0,0,0,1,0,1
3473,5,0,0,0,0,0,0,5
3474,2,0,0,0,0,0,0,2
3475,2,0,0,0,0,0,0,2
3476,1,0,0,0,0,0,1,2
3477,3,0,0,0,0,0,0,3
3478,1,0,0,0,0,0,0,1
3479,2,0,0,0,0,0,0,2
3480,3,0,0,0,0,0,0,3
3483,1,0,0,0,0,0,0,1
3484,1,0,0,0,0,0,0,1
3485,1,0,0,0,0,0,0,1
3487,1,0,0,0,0,0,0,1
3488,1,0,0,0,0,0,0,1
3490,4,0,0,0,0,0,0,4
3491,1,0,0,0,0,0,0,1
3493,1,0,0,0,0,0,0,1
3496,2,0,0,0,0,0,0,2
3497,2,0,0,0,0,0,0,2
3500,6,0,1,0,0,0,0,7
3501,0,1,0,0,0,0,0,1
3505,1,0,0,0,0,0,0,1
3506,2,0,0,0,0,0,0,2
3507,3,0,0,0,0,0,0,3
3508,2,0,1,0,0,0,0,3
3510,2,0,0,0,0,1,1,4
3511,1,0,0,0,0,0,0,1
3513,1,0,0,0,0,0,0,1
3515,2,0,0,0,0,0,0,2
3518,2,0,0,0,0,0,0,2
3519,2,0,0,0,0,0,0,2
3520,11,1,0,0,0,1,0,13
3521,1,0,2,0,0,1,0,4
3525,1,0,0,0,0,0,0,1
3526,2,0,0,0,0,0,0,2
3527,3,0,0,0,0,0,0,3
3529,5,0,0,0,0,0,0,5
3530,2,0,0,0,0,0,0,2
3531,5,0,0,0,0,0,0,5
3532,1,0,0,0,0,0,0,1
3533,2,1,0,0,0,0,0,3
3534,1,0,0,0,0,0,0,1
3535,1,0,0,0,0,0,0,1
3536,1,0,0,0,0,0,0,1
3537,1,0,0,0,0,0,0,1
3538,2,0,0,0,0,0,0,2
3539,5,0,0,0,0,0,0,5
3540,3,0,0,0,0,0,0,3
3541,1,0,0,0,0,0,1,2
3542,2,1,0,0,0,0,0,3
3544,1,0,0,0,0,0,0,1
3545,2,0,0,0,0,0,0,2
3546,2,0,1,0,1,0,0,4
3547,5,0,0,0,0,0,0,5
3548,1,0,0,0,0,0,0,1
3549,3,0,0,0,0,0,0,3
3550,3,0,1,0,0,0,0,4
3551,1,0,0,0,0,0,0,1
3552,1,0,0,0,0,0,0,1
3555,1,0,0,0,0,0,0,1
3558,2,0,0,0,0,0,0,2
3559,2,0,0,0,0,0,0,2
3560,7,1,0,0,0,1,0,9
3561,1,0,0,0,0,0,0,1
3562,0,1,0,0,0,0,0,1
3563,1,0,0,0,0,0,0,1
3564,3,0,0,0,0,0,0,3
3565,2,0,0,0,0,0,0,2
3566,1,0,0,0,0,0,0,1
3567,2,0,0,0,0,0,0,2
3568,1,0,0,0,0,0,0,1
3569,1,0,0,0,0,0,0,1
3570,1,0,0,0,0,0,0,1
3572,2,0,0,0,0,0,0,2
3574,2,0,0,0,0,0,0,2
3577,1,0,0,0,0,0,0,1
3578,1,0,0,0,0,0,0,1
3580,1,0,0,0,0,0,0,1
3581,1,0,0,0,0,0,0,1
3582,1,0,0,0,0,0,0,1
3583,1,0,0,0,0,0,0,1
3585,2,0,0,0,0,0,0,2
3586,0,0,1,0,0,0,0,1
3587,2,0,0,0,0,0,0,2
3588,3,0,0,0,0,0,0,3
3590,4,0,0,0,0,0,0,4
3591,3,0,0,0,0,0,0,3
3592,1,0,0,0,0,0,0,1
3593,2,0,0,0,0,0,0,2
3595,1,0,0,0,0,0,0,1
3596,0,0,0,0,0,1,0,1
3597,1,0,0,0,0,0,0,1
3598,2,0,0,0,0,0,0,2
3599,3,0,0,0,0,0,0,3
3600,10,0,0,0,0,1,0,11
3601,3,0,0,0,0,0,0,3
3602,3,1,0,0,0,1,0,5
3603,3,0,0,0,0,0,0,3
3604,1,0,0,0,0,0,0,1
3605,1,0,0,0,0,0,0,1
3606,3,0,0,0,0,0,0,3
3607,2,0,0,0,0,0,0,2
3608,2,0,0,0,0,0,0,2
3609,3,0,0,0,0,1,0,4
3610,3,0,0,0,0,0,0,3
3611,1,0,0,0,0,1,0,2
3612,3,0,0,0,0,0,0,3
3613,3,0,0,0,0,0,0,3
3614,0,0,0,0,0,1,0,1
3615,2,0,1,0,0,0,0,3
3616,2,0,0,0,0,0,0,2
3617,1,0,0,0,0,0,0,1
3619,2,0,0,0,0,0,0,2
3620,5,0,0,0,0,0,0,5
3621,2,1,0,0,0,0,0,3
3623,1,0,0,0,0,1,0,2
3624,1,0,0,0,0,0,0,1
3625,1,0,0,0,0,0,0,1
3626,3,0,0,0,0,0,0,3
3627,0,1,0,0,0,0,0,1
3628,1,0,0,0,0,0,0,1
3630,1,0,0,0,0,0,0,1
3631,1,0,0,0,0,0,0,1
3632,3,0,0,0,0,0,0,3
3633,1,0,0,0,0,0,0,1
3634,3,0,0,0,0,1,0,4
3636,2,0,0,0,0,0,0,2
3637,3,0,0,0,0,0,0,3
3638,2,0,0,0,0,1,0,3
3639,1,0,0,0,0,0,0,1
3640,7,0,2,0,0,2,0,11
3641,2,0,0,0,0,0,0,2
3642,1,0,0,0,0,0,0,1
3644,0,1,0,0,0,0,0,1
3645,3,1,0,0,0,0,0,4
3648,2,0,0,0,0,0,0,2
3649,1,0,0,0,0,0,0,1
3650,1,0,0,0,0,1,0,2
3653,3,0,0,0,0,0,0,3
3654,2,0,0,0,0,0,0,2
3656,2,0,0,0,0,0,0,2
3657,1,0,0,0,0,0,0,1
3658,2,0,0,0,0,0,0,2
3659,1,0,0,0,0,0,0,1
3660,0,1,0,0,0,0,0,1
3662,2,0,0,0,0,0,0,2
3664,2,0,0,0,0,0,0,2
3666,0,0,0,0,0,1,0,1
3667,1,0,0,0,0,0,1,2
3668,2,0,0,0,0,0,0,2
3669,1,0,0,0,0,0,0,1
3670,1,1,1,0,1,0,0,4
3671,0,0,0,0,0,1,0,1
3672,2,0,0,0,0,0,0,2
3673,1,0,0,0,0,0,0,1
3674,1,0,0,0,0,0,0,1
3675,1,0,0,0,0,0,0,1
3678,1,0,0,0,0,0,0,1
3680,9,0,3,0,0,2,0,14
3681,3,0,0,0,0,0,0,3
3682,1,0,0,0,0,0,0,1
3685,2,0,0,0,0,1,0,3
3688,2,0,0,0,0,1,0,3
3689,1,0,0,0,0,0,0,1
3690,2,0,0,0,0,0,0,2
3691,1,0,1,0,0,0,0,2
3692,1,0,0,0,0,0,0,1
3694,2,0,0,0,0,0,0,2
3695,2,0,0,0,0,0,0,2
3696,1,0,0,0,0,0,0,1
3697,1,0,0,0,0,0,0,1
3698,1,0,0,0,0,0,0,1
3699,2,0,0,0,0,0,0,2
3700,1,0,0,0,0,1,0,2
3701,2,0,0,0,0,0,0,2
3703,3,0,0,0,0,0,0,3
3705,5,0,0,0,0,0,0,5
3706,2,0,0,0,0,0,0,2
3708,2,0,0,0,0,0,0,2
3709,2,0,0,0,0,0,0,2
3710,2,1,0,0,0,0,0,3
3712,1,0,0,0,0,0,0,1
3714,1,0,0,0,0,0,0,1
3715,3,0,0,0,0,0,0,3
3716,3,0,0,0,0,0,0,3
3717,2,0,0,0,0,0,0,2
3718,1,0,0,0,0,0,0,1
3720,13,1,0,0,0,1,0,15
3721,2,0,0,0,0,0,0,2
3722,1,0,0,0,0,1,0,2
3723,1,0,0,0,0,0,0,1
3724,1,0,0,0,0,1,0,2
3725,1,0,0,0,0,0,0,1
3726,2,0,0,0,0,0,0,2
3728,1,1,0,0,0,0,0,2
3729,1,0,0,0,0,0,0,1
3730,2,0,0,0,0,0,0,2
3731,1,0,0,0,0,1,0,2
3732,2,0,0,0,0,0,0,2
3733,1,0,0,0,0,0,0,1
3734,1,0,0,0,0,1,0,2
3736,3,0,0,0,0,0,0,3
3737,1,0,0,0,0,0,0,1
3739,2,0,0,0,0,0,0,2
3740,1,0,0,0,0,0,0,1
3741,4,0,0,0,0,0,0,4
3742,2,0,0,0,0,0,0,2
3743,2,1,0,0,0,0,0,3
3745,1,0,0,0,0,0,0,1
3746,3,0,0,0,0,0,0,3
3747,1,0,0,0,0,0,0,1
3748,1,0,0,0,0,0,0,1
3749,2,0,0,0,0,0,0,2
3750,1,0,0,0,0,0,0,1
3751,2,0,0,0,0,0,0,2
3753,2,1,0,0,0,0,0,3
3754,1,0,0,0,0,0,0,1
3755,1,0,0,0,0,1,0,2
3756,3,0,0,0,0,0,0,3
3758,3,0,0,0,0,0,0,3
3759,0,0,0,0,0,1,0,1
3760,8,1,0,0,0,0,1,10
3761,1,0,0,0,0,0,0,1
3762,2,0,0,0,0,0,0,2
3763,1,0,0,0,0,0,0,1
3764,2,0,0,0,0,1,0,3
3765,1,0,0,0,0,0,0,1
3766,1,0,0,0,0,0,0,1
3767,0,0,1,0,0,0,0,1
3769,1,0,0,0,0,0,0,1
3773,1,0,0,0,0,0,0,1
3774,0,0,0,0,0,0,1,1
3776,1,0,0,0,0,0,0,1
3777,0,0,0,0,0,1,0,1
3778,1,0,0,0,0,0,0,1
3779,2,0,0,0,0,0,0,2
3780,1,0,0,0,0,2,0,3
3781,1,0,0,0,0,0,0,1
3782,1,0,0,0,0,0,0,1
3783,2,0,0,0,0,0,0,2
3784,0,0,1,0,0,1,0,2
3785,1,0,0,0,0,0,0,1
3787,1,0,0,0,0,0,0,1
3788,2,0,0,0,0,0,0,2
3789,2,0,0,0,0,0,0,2
3790,1,0,0,0,0,0,0,1
3791,0,1,0,0,0,0,0,1
3795,1,0,0,0,0,0,0,1
3796,1,0,0,0,0,0,0,1
3798,1,0,0,0,0,0,0,1
3800,7,0,0,0,0,0,0,7
3802,1,0,0,0,0,0,0,1
3804,1,0,0,0,0,0,0,1
3806,1,0,0,0,0,0,0,1
3807,1,0,0,0,0,0,0,1
3808,2,0,0,0,0,0,0,2
3809,1,0,0,0,0,0,0,1
3810,1,0,0,0,0,0,0,1
3812,0,0,1,0,0,0,0,1
3814,2,0,0,0,0,0,0,2
3815,1,0,0,0,0,0,0,1
3816,1,0,0,0,0,0,0,1
3817,1,0,0,0,0,0,0,1
3818,1,0,0,0,0,0,0,1
3819,1,0,0,0,0,0,0,1
3820,2,0,1,0,0,0,0,3
3821,1,0,1,0,0,0,0,2
3822,3,1,0,0,0,0,0,4
3823,0,1,0,0,0,0,0,1
3824,1,0,0,0,0,0,0,1
3826,0,0,0,0,0,0,1,1
3827,2,0,0,0,0,1,1,4
3829,3,0,0,0,0,0,0,3
3832,1,2,0,0,0,0,0,3
3833,1,0,1,0,0,1,0,3
3834,2,0,0,0,0,0,0,2
3835,1,0,0,0,0,0,0,1
3836,0,1,0,0,0,0,0,1
3837,2,0,0,0,0,0,0,2
3838,0,0,0,0,0,1,0,1
3839,1,0,0,0,0,0,1,2
3840,7,1,0,0,0,1,1,10
3841,3,0,0,0,0,0,0,3
3842,1,0,0,0,0,0,0,1
3844,1,0,0,0,0,1,0,2
3846,1,0,0,0,0,0,0,1
3847,1,0,0,0,0,0,0,1
3848,1,0,1,0,0,0,0,2
3849,1,0,0,0,0,0,0,1
3850,1,0,0,0,0,0,0,1
3851,2,0,0,0,0,0,0,2
3852,1,0,0,0,0,1,0,2
3853,2,0,0,0,0,1,0,3
3855,1,0,0,0,0,0,0,1
3856,3,0,1,0,0,0,0,4
3858,1,0,0,0,0,0,0,1
3859,1,0,0,0,0,0,0,1
3860,3,0,0,0,0,0,0,3
3861,3,0,0,0,1,0,0,4
3862,4,0,0,0,0,1,0,5
3864,2,0,0,0,0,0,0,2
3865,2,0,0,0,0,0,0,2
3866,1,0,0,0,0,0,0,1
3868,1,0,0,0,0,0,0,1
3869,1,0,0,0,0,0,0,1
3870,1,0,0,0,0,0,0,1
3871,2,0,0,0,0,0,0,2
3872,2,0,0,0,0,0,0,2
3873,0,0,0,0,0,1,0,1
3874,1,0,1,0,0,0,0,2
3875,1,0,0,0,0,0,0,1
3876,1,0,0,0,0,0,0,1
3877,3,0,0,0,0,0,0,3
3879,2,0,0,0,0,0,0,2
3880,7,0,0,0,0,0,0,7
3883,2,0,0,0,0,0,0,2
3885,0,0,1,0,0,0,0,1
3887,2,0,0,0,0,0,0,2
3888,2,0,0,0,0,0,0,2
3889,2,0,0,0,0,0,0,2
3892,2,1,0,0,0,0,0,3
3897,3,0,0,0,0,0,0,3
3898,2,1,1,0,0,0,0,4
3899,1,0,0,0,0,0,0,1
3901,1,0,0,0,0,0,0,1
3902,3,0,0,0,0,0,0,3
3905,1,0,0,0,0,1,0,2
3906,0,0,0,0,0,1,0,1
3908,2,0,0,0,0,0,0,2
3911,1,0,0,0,0,1,0,2
3912,2,0,0,0,0,0,0,2
3915,1,0,0,0,0,0,0,1
3916,2,0,0,0,0,1,0,3
3917,1,0,1,0,0,0,0,2
3918,0,1,0,0,0,0,0,1
3919,3,0,0,0,0,0,0,3
3920,8,0,0,0,0,1,0,9
3921,1,0,0,0,0,0,0,1
3922,1,0,0,0,0,0,0,1
3923,2,0,0,0,0,0,0,2
3924,1,0,0,0,0,1,0,2
3925,1,1,0,0,0,0,0,2
3927,1,0,0,0,0,0,0,1
3928,1,0,0,0,0,0,0,1
3932,1,0,0,0,0,0,0,1
3933,1,0,0,0,0,0,0,1
3936,1,0,0,0,0,0,0,1
3937,2,0,0,0,0,0,0,2
3938,1,0,0,0,0,0,0,1
3940,2,0,0,0,0,0,0,2
3942,3,0,0,0,0,0,0,3
3943,2,0,0,0,0,0,0,2
3949,2,0,0,0,0,0,0,2
3950,4,0,0,0,0,0,0,4
3952,1,1,0,0,0,0,0,2
3956,1,0,0,0,0,0,0,1
3957,2,0,0,0,0,0,0,2
3959,1,0,0,0,0,0,0,1
3960,6,1,0,0,0,1,1,9
3963,2,0,0,0,0,0,0,2
3965,2,0,0,0,0,0,0,2
3967,1,0,0,0,0,0,0,1
3969,3,0,0,0,0,0,0,3
3970,2,1,0,0,0,0,0,3
3971,1,0,0,0,0,0,0,1
3972,2,0,0,0,0,0,0,2
3973,2,0,0,0,0,1,0,3
3975,3,0,0,0,0,0,0,3
3978,2,0,0,0,0,0,0,2
3979,4,0,0,0,0,0,0,4
3980,0,1,0,0,0,0,0,1
3981,3,0,0,0,0,0,0,3
3982,1,0,0,0,0,0,0,1
3985,1,0,0,0,0,0,0,1
3986,1,0,0,0,0,0,0,1
3987,1,0,0,0,0,0,0,1
3988,0,0,0,0,0,0,1,1
3989,1,0,0,0,0,0,0,1
3990,2,0,0,0,0,0,0,2
3994,2,0,0,0,0,0,0,2
3996,2,0,0,0,0,0,0,2
3997,2,0,0,0,0,0,0,2
4000,5,0,1,0,0,1,0,7
4002,1,0,0,0,0,0,0,1
4004,1,0,0,0,0,0,0,1
4005,1,0,0,0,0,0,0,1
4006,1,0,0,0,0,0,0,1
4007,1,0,0,0,0,0,0,1
4008,2,0,0,0,0,1,0,3
4009,1,0,0,0,0,0,0,1
4010,1,0,0,0,0,0,0,1
4012,4,0,0,0,0,0,0,4
4014,1,0,0,0,0,0,0,1
4015,1,0,0,0,0,1,0,2
4016,1,0,0,0,0,1,0,2
4017,1,0,0,0,0,0,0,1
4018,0,0,0,0,0,1,0,1
4019,1,0,0,0,0,0,0,1
4020,3,0,0,0,0,0,0,3
4022,1,0,0,0,0,0,0,1
4027,2,0,1,0,0,0,0,3
4028,1,0,0,0,0,0,0,1
4029,4,0,0,0,0,0,0,4
4030,1,0,0,0,0,0,0,1
4031,2,0,0,0,0,0,0,2
4032,1,0,0,0,1,0,0,2
4040,6,0,0,0,0,0,0,6
4041,1,0,0,0,0,0,0,1
4044,3,0,1,0,0,0,0,4
4045,3,0,0,0,0,0,0,3
4046,2,0,0,0,0,0,0,2
4047,0,0,1,0,0,0,0,1
4048,2,0,0,0,0,0,0,2
4049,1,0,0,0,0,1,0,2
4050,2,0,0,0,0,0,0,2
4051,1,0,0,0,0,1,0,2
4052,2,0,1,0,0,0,0,3
4055,2,0,0,0,0,0,0,2
4057,1,0,0,0,0,0,0,1
4059,3,0,0,0,0,0,0,3
4060,2,0,0,0,0,0,0,2
4061,1,0,0,0,0,0,0,1
4062,2,0,0,0,0,0,0,2
4065,2,0,0,0,0,0,0,2
4066,3,0,0,0,0,0,0,3
4067,1,0,0,0,0,0,0,1
4068,3,0,0,0,0,1,0,4
4069,3,0,0,0,0,0,0,3
4070,2,0,0,0,0,0,0,2
4071,4,0,0,0,0,0,0,4
4074,1,0,0,0,0,0,0,1
4075,1,0,0,0,0,0,0,1
4076,1,0,0,0,0,0,0,1
4078,1,0,0,0,0,0,0,1
4079,1,0,0,0,0,0,0,1
4080,6,1,0,0,0,2,0,9
4081,2,0,0,0,0,0,0,2
4082,1,0,0,0,0,0,0,1
4084,1,0,0,0,0,0,0,1
4086,0,1,0,0,0,0,0,1
4087,1,0,0,0,0,1,0,2
4088,1,0,0,0,0,0,0,1
4089,1,0,0,0,0,0,0,1
4090,1,0,0,0,0,0,0,1
4091,2,0,0,0,0,0,0,2
4092,2,0,0,0,0,0,0,2
4093,1,0,0,0,0,0,0,1
4095,1,0,0,0,0,0,0,1
4098,2,0,0,0,0,0,0,2
4099,2,0,0,0,0,0,0,2
4100,2,0,0,0,0,0,0,2
4101,3,0,0,0,0,0,0,3
4102,1,0,1,0,0,0,0,2
4103,0,0,1,0,0,0,0,1
4104,1,0,1,0,0,0,0,2
4107,2,0,0,0,0,0,0,2
4108,2,0,0,0,0,1,0,3
4109,1,0,0,0,0,0,0,1
4111,1,0,0,0,0,0,0,1
4112,1,1,0,0,0,0,0,2
4113,2,0,0,0,0,0,0,2
4115,1,0,0,0,0,0,0,1
4116,2,0,0,0,0,0,0,2
4117,1,1,0,0,0,0,0,2
4118,4,0,0,0,0,0,0,4
4119,1,0,0,0,0,0,0,1
4120,5,1,0,0,0,0,0,6
4121,3,0,0,0,0,0,0,3
4122,1,0,0,0,0,0,0,1
4123,1,0,0,0,0,0,0,1
4125,1,0,0,0,0,0,0,1
4126,0,0,1,0,0,0,0,1
4127,1,0,0,0,0,0,0,1
4128,0,0,1,0,0,1,0,2
4129,1,0,0,0,0,0,0,1
4130,1,0,0,0,0,0,0,1
4131,1,0,0,0,0,0,0,1
4132,2,0,0,0,0,0,0,2
4134,2,0,0,0,0,0,0,2
4137,2,0,0,0,0,1,0,3
4138,1,0,0,0,0,0,0,1
4140,1,0,0,0,0,0,0,1
4142,0,0,0,0,0,1,0,1
4143,1,0,0,0,0,0,0,1
4145,1,0,0,0,0,0,0,1
4146,3,0,0,0,0,0,0,3
4147,2,0,0,0,0,0,0,2
4149,1,0,0,0,0,0,0,1
4151,1,0,0,0,0,0,0,1
4152,1,0,1,0,0,1,0,3
4153,1,0,1,0,0,0,0,2
4158,1,0,0,0,0,0,0,1
4160,13,0,1,0,0,1,0,15
4161,1,0,0,0,0,0,0,1
4162,1,0,0,0,0,0,0,1
4163,1,0,0,0,0,0,0,1
4166,3,0,0,0,0,0,0,3
4167,0,1,0,0,0,0,0,1
4169,0,0,1,0,0,0,0,1
4170,1,0,0,0,0,0,0,1
4172,1,0,0,0,0,0,0,1
4173,1,0,0,0,0,0,0,1
4174,2,0,0,0,0,0,0,2
4175,3,0,0,0,0,0,0,3
4176,1,0,0,0,0,0,0,1
4178,1,0,0,0,0,0,0,1
4179,1,0,0,0,0,0,0,1
4180,1,0,0,0,0,0,0,1
4181,1,1,0,0,0,0,0,2
4184,1,0,0,0,0,0,0,1
4186,2,0,0,0,0,0,0,2
4187,1,0,0,0,0,0,0,1
4188,1,0,0,0,0,0,0,1
4191,1,0,0,0,0,0,0,1
4192,1,0,0,0,0,0,0,1
4193,2,0,0,0,0,0,0,2
4194,1,0,0,0,0,0,0,1
4196,1,0,0,0,0,0,0,1
4197,1,0,0,0,0,0,0,1
4199,2,0,0,0,0,0,0,2
4200,4,1,1,0,0,0,0,6
4201,1,0,0,0,0,0,0,1
4202,2,0,0,0,0,0,0,2
4203,2,0,0,0,0,0,0,2
4204,2,0,0,0,0,0,0,2
4206,1,0,0,0,0,0,0,1
4208,2,0,0,0,0,0,0,2
4209,2,0,0,0,0,0,0,2
4212,2,0,1,0,0,0,0,3
4213,1,0,0,0,0,0,0,1
4214,3,0,0,0,0,0,0,3
4216,0,0,0,0,0,0,1,1
4217,1,0,0,0,0,0,0,1
4219,3,0,0,0,0,0,0,3
4220,2,0,0,0,0,0,0,2
4221,1,0,0,0,0,0,0,1
4222,1,0,0,0,0,0,0,1
4223,2,0,0,0,0,0,0,2
4225,0,1,0,0,0,0,0,1
4227,1,0,0,0,0,0,0,1
4228,1,0,1,0,0,0,0,2
4229,3,0,0,0,0,0,0,3
4230,1,0,0,0,0,0,0,1
4231,1,0,0,0,0,0,0,1
4233,1,0,0,0,0,0,0,1
4234,2,0,0,0,0,0,0,2
4236,0,0,0,0,0,1,0,1
4237,1,0,0,0,0,0,0,1
4238,1,0,0,0,0,0,0,1
4239,1,0,0,0,0,0,0,1
4240,6,0,0,0,0,0,1,7
4242,1,0,0,0,0,0,0,1
4244,1,0,0,0,0,0,0,1
4246,2,0,0,0,0,1,0,3
4247,1,0,0,0,0,0,0,1
4248,1,0,0,0,0,0,0,1
4249,2,0,0,0,0,0,0,2
4251,1,0,0,0,0,0,0,1
4252,1,0,0,0,0,0,0,1
4253,1,0,0,0,0,0,0,1
4254,0,1,0,0,0,0,0,1
4255,1,0,0,0,0,0,0,1
4256,3,0,0,0,0,0,0,3
4259,1,0,0,0,0,0,0,1
4260,1,0,0,0,0,0,0,1
4261,1,0,1,0,0,0,0,2
4263,1,0,0,0,0,0,0,1
4264,1,0,0,0,0,0,0,1
4265,1,0,0,0,0,0,0,1
4267,1,0,0,0,0,0,0,1
4271,1,0,0,0,0,0,0,1
4275,3,0,0,0,0,0,0,3
4277,1,0,0,0,0,0,0,1
4278,2,0,0,0,0,0,0,2
4279,2,0,0,0,0,0,0,2
4280,10,0,1,0,0,0,0,11
4282,1,0,0,0,0,0,0,1
4283,1,0,0,0,0,0,1,2
4286,1,0,0,0,0,0,0,1
4287,2,0,0,0,0,0,0,2
4288,0,0,1,0,0,0,0,1
4289,1,0,0,0,0,1,0,2
4290,1,0,0,0,0,0,1,2
4292,1,0,0,0,0,1,0,2
4293,1,0,0,0,0,0,0,1
4294,4,0,0,0,0,0,0,4
4295,1,0,0,0,0,1,0,2
4296,1,0,0,0,0,0,0,1
4297,1,0,0,0,0,1,0,2
4298,1,0,0,0,0,0,0,1
4299,1,0,0,0,0,0,0,1
4300,2,0,0,0,0,0,0,2
4302,4,0,0,0,0,0,0,4
4303,2,0,0,0,0,0,0,2
4304,2,0,0,0,0,0,0,2
4307,1,0,0,0,0,0,0,1
4308,1,0,0,0,0,0,0,1
4309,1,0,0,0,0,0,0,1
4310,1,0,0,0,0,0,0,1
4313,2,0,0,0,0,0,0,2
4314,0,0,0,0,0,1,0,1
4318,2,0,0,0,0,0,0,2
4319,1,0,0,0,0,0,0,1
4320,1,0,0,0,0,0,0,1
4322,1,1,0,0,0,0,0,2
4325,1,0,0,0,0,0,0,1
4328,1,0,1,0,0,0,0,2
4329,1,0,0,0,0,0,0,1
4330,1,0,1,0,0,0,0,2
4333,0,0,0,0,0,1,0,1
4334,1,0,0,0,0,0,0,1
4335,1,0,0,0,0,1,0,2
4336,2,0,0,0,0,0,0,2
4337,3,0,0,0,0,0,0,3
4338,3,0,0,0,0,0,0,3
4339,2,0,0,0,0,0,0,2
4342,1,1,0,0,0,0,0,2
4343,1,0,0,0,0,0,0,1
4344,2,0,0,0,0,0,0,2
4345,1,0,0,0,0,0,0,1
4346,2,0,0,0,0,0,0,2
4348,1,0,0,0,0,0,0,1
4349,1,0,0,0,0,0,0,1
4351,1,0,0,0,0,0,0,1
4355,1,1,0,0,0,0,0,2
4356,2,0,0,0,0,0,0,2
4357,1,0,0,0,0,0,0,1
4360,3,0,0,0,0,2,0,5
4362,1,0,0,0,0,0,0,1
4363,2,0,0,0,0,0,0,2
4368,2,0,0,0,0,0,0,2
4371,1,0,0,0,0,0,0,1
4373,1,0,0,0,0,0,0,1
4375,2,0,0,0,0,0,0,2
4376,1,0,0,0,0,0,0,1
4377,1,0,0,0,0,0,0,1
4378,1,0,0,0,0,0,0,1
4379,1,0,0,0,0,0,0,1
4380,0,0,0,0,0,1,0,1
4381,1,0,0,0,0,0,0,1
4382,2,0,1,0,0,0,0,3
4384,0,0,0,0,0,1,0,1
4386,1,0,0,0,0,0,0,1
4391,1,0,0,0,0,0,0,1
4392,1,0,0,0,0,0,0,1
4393,4,0,0,0,0,0,0,4
4394,2,0,0,0,0,0,0,2
4395,1,0,0,0,0,0,0,1
4400,9,2,0,0,0,2,0,13
4402,1,0,0,0,0,0,0,1
4403,1,0,0,0,0,0,0,1
4404,1,0,0,0,0,0,0,1
4408,2,0,0,0,0,0,0,2
4409,2,0,0,0,0,0,0,2
4411,1,0,0,0,0,1,0,2
4412,1,0,0,0,0,0,0,1
4417,2,0,0,0,0,0,0,2
4418,1,0,0,0,0,0,0,1
4421,4,0,0,0,0,0,0,4
4423,1,0,0,0,0,0,0,1
4425,1,0,0,0,0,0,0,1
4428,2,0,0,0,0,0,0,2
4429,1,0,0,0,0,0,0,1
4430,1,0,0,0,0,0,0,1
4434,0,0,1,0,0,0,0,1
4435,1,0,0,0,0,0,0,1
4436,2,0,0,0,0,0,0,2
4437,1,0,1,0,0,0,0,2
4439,0,0,0,0,0,1,0,1
4440,5,0,0,0,0,0,0,5
4442,2,0,0,0,0,0,0,2
4445,2,0,0,0,0,0,0,2
4450,1,0,0,0,0,0,0,1
4451,2,0,0,0,0,0,0,2
4452,1,0,0,0,0,0,0,1
4453,1,0,0,0,0,0,0,1
4454,1,0,0,0,0,1,0,2
4455,1,0,0,0,0,0,0,1
4456,3,0,0,0,0,0,0,3
4457,1,0,0,0,0,0,0,1
4458,1,0,0,0,0,0,0,1
4461,2,0,1,0,0,0,0,3
4462,1,0,0,0,0,0,0,1
4466,1,0,0,0,0,0,0,1
4468,2,0,0,0,0,0,0,2
4470,1,0,0,0,0,0,0,1
4473,2,0,1,0,0,0,0,3
4474,0,0,0,0,0,1,0,1
4475,3,0,0,0,0,0,0,3
4478,1,0,0,0,0,1,0,2
4479,1,0,0,0,0,0,0,1
4480,9,0,2,0,0,0,0,11
4481,2,0,0,0,0,0,0,2
4484,1,1,0,0,0,0,0,2
4485,2,0,0,0,0,0,0,2
4488,1,0,0,0,0,0,0,1
4490,1,0,0,0,0,0,0,1
4491,2,0,0,0,0,0,0,2
4492,2,0,0,0,0,0,0,2
4493,1,0,0,0,0,0,0,1
4496,1,0,0,0,0,0,0,1
4499,1,0,0,0,0,0,0,1
4500,2,0,0,0,0,1,0,3
4502,1,0,0,0,0,0,0,1
4506,2,0,0,0,0,0,0,2
4509,1,0,0,0,0,0,0,1
4510,1,0,0,0,0,0,0,1
4511,1,0,0,0,0,0,0,1
4514,0,0,1,0,0,0,0,1
4517,1,0,0,0,0,0,0,1
4518,0,0,1,0,0,0,0,1
4520,5,1,0,0,0,1,0,7
4521,2,0,0,0,0,0,0,2
4523,1,0,0,0,0,0,0,1
4524,1,0,0,0,0,0,0,1
4525,1,0,0,0,0,0,0,1
4527,2,0,0,0,0,0,0,2
4528,1,0,0,0,0,0,0,1
4529,1,0,0,0,0,0,0,1
4530,1,0,0,0,0,0,0,1
4531,1,0,0,0,0,0,0,1
4532,2,0,0,0,0,0,0,2
4534,2,0,0,0,0,0,0,2
4536,1,0,0,0,0,0,0,1
4538,2,0,0,0,0,0,0,2
4540,3,0,0,0,0,0,0,3
4543,1,0,0,0,0,0,0,1
4544,1,0,0,0,0,0,0,1
4545,5,0,0,0,0,0,0,5
4547,1,0,0,0,0,0,0,1
4548,2,0,0,0,0,0,0,2
4550,1,0,0,0,0,0,0,1
4551,3,0,0,0,0,0,0,3
4552,2,0,0,0,0,0,0,2
4553,0,0,1,0,0,0,0,1
4554,2,0,0,0,0,0,0,2
4555,1,0,0,0,0,0,0,1
4557,2,0,0,0,0,0,0,2
4560,13,0,1,0,0,0,0,14
4561,1,0,0,0,0,0,0,1
4563,1,0,0,0,0,0,0,1
4564,3,0,0,0,0,0,0,3
4565,2,0,0,0,0,0,0,2
4566,2,0,0,0,0,0,0,2
4572,1,0,0,0,0,0,0,1
4573,1,0,0,0,0,0,0,1
4576,3,0,0,0,0,0,0,3
4579,1,0,0,0,0,0,0,1
4580,1,0,0,0,0,0,0,1
4584,1,0,0,0,0,0,0,1
4592,1,0,0,0,0,1,0,2
4593,1,0,0,0,0,0,0,1
4594,2,0,0,0,0,0,0,2
4595,1,0,0,0,0,0,0,1
4599,1,0,0,0,0,0,0,1
4600,2,0,1,0,0,0,0,3
4602,3,0,0,0,0,0,0,3
4603,1,0,0,0,0,0,0,1
4604,1,0,0,0,0,0,0,1
4605,1,0,0,0,0,0,0,1
4606,1,0,0,0,0,0,0,1
4609,1,0,1,0,0,0,0,2
4611,1,0,0,0,0,0,0,1
4613,1,0,1,0,0,0,0,2
4614,1,0,1,0,0,0,0,2
4615,1,0,0,0,0,0,0,1
4617,2,0,0,0,0,0,0,2
4619,0,1,0,0,0,0,0,1
4620,4,1,0,0,0,0,0,5
4621,2,0,0,0,0,0,0,2
4622,1,0,0,0,0,0,0,1
4623,1,0,0,0,0,0,0,1
4625,1,0,0,0,0,0,0,1
4627,1,0,0,0,0,0,0,1
4631,1,0,0,0,0,0,0,1
4632,1,0,0,0,0,0,0,1
4633,0,1,0,0,0,0,0,1
4634,1,0,0,0,0,0,0,1
4635,1,0,0,0,0,0,0,1
4636,1,0,0,0,0,0,0,1
4637,5,0,0,0,0,0,0,5
4639,1,0,0,0,0,0,0,1
4640,5,0,0,0,0,0,0,5
4643,1,0,0,0,0,0,0,1
4646,1,0,0,0,0,0,0,1
4648,1,0,0,0,0,0,0,1
4649,1,0,0,0,0,0,0,1
4650,5,0,0,0,0,0,0,5
4652,1,0,0,0,0,0,0,1
4654,1,0,0,0,0,0,0,1
4655,1,0,0,0,0,0,0,1
4657,2,0,0,0,0,0,0,2
4658,2,0,0,0,0,0,0,2
4662,1,0,0,0,0,0,0,1
4667,0,1,0,0,0,0,0,1
4668,2,0,0,0,0,0,0,2
4669,2,0,0,0,0,0,0,2
4672,1,0,0,0,0,0,0,1
4673,1,0,0,0,0,0,0,1
4675,0,0,1,0,0,0,0,1
4678,1,0,0,0,0,1,0,2
4680,6,1,0,0,0,0,0,7
4683,2,0,0,0,0,0,0,2
4686,1,0,0,0,0,0,0,1
4688,2,0,0,0,0,0,0,2
4689,1,0,0,0,0,0,0,1
4690,1,0,0,0,0,0,0,1
4692,1,0,0,0,0,0,0,1
4694,1,0,0,0,0,1,0,2
4696,2,0,0,0,0,0,0,2
4697,3,0,0,0,0,0,0,3
4699,0,0,1,0,0,0,0,1
4700,0,0,0,0,0,0,1,1
4702,1,0,0,0,0,0,0,1
4705,2,0,0,0,0,0,0,2
4707,1,0,0,0,0,0,1,2
4709,1,0,1,0,0,0,0,2
4711,1,0,0,0,0,0,0,1
4712,1,0,0,0,0,0,0,1
4713,1,0,0,0,0,0,0,1
4714,1,0,0,0,0,0,0,1
4716,2,0,0,0,0,0,0,2
4717,2,0,0,0,0,0,0,2
4719,0,0,0,0,0,0,1,1
4720,10,0,0,0,0,0,0,10
4724,1,0,0,0,0,0,0,1
4725,1,0,0,0,0,0,0,1
4726,1,0,0,0,0,0,0,1
4727,1,0,0,0,0,0,0,1
4728,1,0,0,0,0,0,0,1
4729,1,0,0,0,0,0,0,1
4730,1,0,0,0,0,0,0,1
4732,2,0,0,0,0,0,0,2
4733,1,0,0,0,0,0,0,1
4740,1,0,1,0,0,1,0,3
4741,2,0,0,0,0,0,0,2
4742,1,0,0,0,0,0,0,1
4743,1,0,0,0,0,0,0,1
4744,1,0,0,0,0,0,0,1
4745,1,0,0,0,0,1,0,2
4746,0,0,1,0,0,1,0,2
4749,2,0,0,0,0,0,0,2
4752,1,0,0,0,0,0,0,1
4757,2,0,0,0,0,0,0,2
4758,1,0,0,0,0,0,0,1
4759,2,0,0,0,0,0,0,2
4760,2,0,0,0,0,0,0,2
4761,1,0,0,0,0,0,1,2
4763,1,0,0,0,0,0,0,1
4764,1,0,0,0,0,0,0,1
4765,0,0,0,0,0,1,0,1
4768,1,0,0,0,0,0,0,1
4772,2,0,0,0,0,0,0,2
4773,1,0,0,0,0,0,0,1
4777,3,0,0,0,0,0,0,3
4778,0,0,1,0,0,0,0,1
4779,1,0,0,0,0,0,0,1
4781,2,0,0,0,0,0,0,2
4785,1,0,0,0,0,0,0,1
4786,1,0,0,0,0,0,0,1
4788,2,0,0,0,0,0,0,2
4792,1,0,0,0,0,0,0,1
4794,2,0,0,0,0,0,0,2
4795,1,0,0,0,0,0,0,1
4796,1,0,0,0,0,0,0,1
4798,1,0,0,0,0,0,0,1
4799,2,0,0,0,0,0,0,2
4800,10,0,3,0,0,0,0,13
4802,1,0,0,0,0,0,0,1
4804,0,0,1,0,0,0,0,1
4805,1,0,0,0,0,0,0,1
4806,2,0,0,0,0,0,0,2
4810,0,0,0,0,1,0,0,1
4813,1,0,0,0,0,0,0,1
4814,1,0,0,0,0,0,0,1
4817,4,0,0,0,0,0,0,4
4821,2,0,0,0,0,0,0,2
4822,0,0,0,0,0,0,1,1
4824,1,0,0,0,0,0,0,1
4825,1,0,0,0,0,0,0,1
4826,1,0,0,0,0,0,0,1
4829,1,0,0,0,0,0,0,1
4830,1,0,0,0,0,0,0,1
4833,2,0,0,0,0,0,0,2
4834,4,0,0,0,0,0,0,4
4835,1,0,0,0,0,0,0,1
4836,1,0,0,0,0,0,0,1
4837,2,0,0,0,0,0,0,2
4839,2,0,0,0,0,0,0,2
4840,3,0,0,0,0,0,0,3
4846,3,0,0,0,0,0,0,3
4847,2,0,0,0,0,0,0,2
4848,1,1,0,0,0,0,0,2
4849,1,0,0,0,0,0,0,1
4852,1,0,0,0,0,0,0,1
4853,0,0,2,0,0,0,0,2
4854,0,0,0,0,1,0,0,1
4857,2,0,0,0,0,1,0,3
4858,1,0,0,0,0,0,0,1
4860,1,1,0,0,0,0,0,2
4862,1,0,0,0,0,0,0,1
4865,1,0,0,0,0,0,0,1
4866,2,0,0,0,0,0,0,2
4867,2,0,0,0,0,0,0,2
4869,1,0,0,0,0,0,0,1
4873,3,0,0,0,0,0,0,3
4875,2,0,0,0,0,0,0,2
4876,1,0,0,0,0,0,0,1
4877,1,0,0,0,0,0,0,1
4878,1,0,0,0,0,0,0,1
4879,2,0,0,0,0,0,0,2
4880,6,0,0,0,0,1,0,7
4882,1,0,0,0,0,0,0,1
4884,1,0,0,0,0,0,0,1
4890,1,0,0,0,0,0,0,1
4891,2,0,0,0,0,0,0,2
4892,1,0,0,0,0,0,0,1
4894,1,0,0,0,0,0,0,1
4897,0,0,0,0,0,0,1,1
4898,1,0,0,0,0,0,0,1
4900,0,0,1,0,0,0,0,1
4902,2,0,0,0,0,0,0,2
4903,1,0,0,0,0,0,0,1
4904,1,0,0,0,0,0,0,1
4905,1,0,0,0,0,0,0,1
4907,1,0,0,0,0,0,0,1
4910,1,0,0,0,0,0,0,1
4911,1,0,0,0,0,0,0,1
4912,1,0,0,0,0,0,0,1
4914,2,0,0,0,0,0,0,2
4917,1,0,0,0,0,0,0,1
4920,5,0,0,0,0,0,0,5
4921,1,0,1,0,0,0,0,2
4922,1,0,0,0,0,0,0,1
4925,1,0,0,0,0,0,0,1
4926,1,0,0,0,0,0,0,1
4929,2,0,0,0,0,0,0,2
4930,0,0,0,0,0,1,0,1
4931,1,0,0,0,0,0,0,1
4933,1,1,0,0,0,0,0,2
4935,1,0,0,0,0,0,0,1
4936,1,0,0,0,0,0,0,1
4942,1,0,0,0,0,0,0,1
4943,1,0,0,0,0,0,0,1
4947,0,1,0,0,0,0,0,1
4950,1,0,0,0,0,0,0,1
4953,0,0,0,0,0,0,1,1
4954,0,0,0,0,0,1,0,1
4956,2,0,0,0,0,0,0,2
4958,1,0,0,0,0,0,0,1
4959,1,0,0,0,0,0,0,1
4960,9,0,0,0,0,0,0,9
4964,1,0,0,0,0,0,0,1
4965,1,0,0,0,0,0,0,1
4968,1,0,0,0,0,0,0,1
4969,2,0,0,0,0,0,0,2
4972,1,0,0,0,0,0,0,1
4977,1,0,0,0,0,0,0,1
4978,0,0,1,0,0,0,0,1
4980,1,0,0,0,0,0,0,1
4984,2,0,0,0,0,0,0,2
4985,1,0,0,0,0,0,0,1
4986,1,0,0,0,0,0,0,1
4989,1,0,1,0,0,0,0,2
4991,2,0,0,0,0,0,0,2
4992,1,1,0,0,0,0,0,2
4993,1,0,0,0,0,0,0,1
4994,1,0,0,0,0,0,0,1
4997,1,0,0,0,0,0,0,1
4998,2,0,0,0,0,0,0,2
5000,4,0,0,0,0,0,0,4
5001,1,0,0,0,0,0,0,1
5004,2,0,0,0,0,0,0,2
5006,1,0,0,0,0,0,0,1
5009,0,1,0,0,0,0,0,1
5010,1,0,0,0,0,0,0,1
5012,1,0,0,0,0,0,0,1
5014,1,0,0,0,0,0,0,1
5015,1,0,0,0,0,0,0,1
5016,2,0,0,0,0,0,0,2
5017,1,0,0,0,0,0,0,1
5018,1,0,0,0,0,0,0,1
5019,3,0,0,0,0,0,0,3
5021,1,0,0,0,0,0,0,1
5022,1,0,0,0,0,0,0,1
5025,1,0,0,0,0,0,0,1
5026,1,0,0,0,0,0,0,1
5029,1,0,0,0,0,0,0,1
5030,2,0,0,0,0,0,0,2
5031,1,0,0,0,0,0,0,1
5033,1,0,0,0,0,0,0,1
5034,1,0,0,0,0,0,0,1
5035,1,0,0,0,0,0,0,1
5037,1,0,0,0,0,0,0,1
5039,1,0,0,0,0,0,0,1
5040,7,0,0,0,0,1,0,8
5041,1,0,0,0,0,0,0,1
5043,1,0,0,0,0,0,0,1
5047,1,0,0,0,0,0,0,1
5050,1,0,0,0,0,0,0,1
5051,2,0,1,0,0,0,0,3
5052,0,0,1,0,0,0,0,1
5054,2,0,0,0,0,0,0,2
5055,1,0,0,0,0,0,0,1
5056,1,0,0,0,0,0,0,1
5057,1,0,0,0,0,0,0,1
5060,1,0,0,0,0,0,0,1
5061,1,1,0,0,0,0,0,2
5066,3,0,0,0,0,0,0,3
5071,1,1,0,0,0,0,0,2
5072,1,0,0,0,0,0,0,1
5075,1,0,0,0,0,0,0,1
5080,6,0,0,0,0,0,0,6
5081,2,0,0,0,0,0,0,2
5090,2,0,0,0,0,0,0,2
5096,1,0,0,0,0,0,0,1
5097,1,0,0,0,0,0,0,1
5101,1,0,1,0,0,0,0,2
5105,2,0,0,0,0,0,0,2
5106,1,0,0,0,0,0,0,1
5107,1,0,0,0,0,0,0,1
5108,1,0,0,0,0,0,0,1
5109,1,0,0,0,0,0,0,1
5110,1,0,0,0,0,0,0,1
5111,1,0,0,0,0,0,0,1
5113,4,0,0,0,0,1,0,5
5114,4,0,0,0,0,0,0,4
5115,2,0,1,0,0,0,0,3
5117,1,0,0,0,0,0,0,1
5119,0,0,1,0,0,0,0,1
5120,4,1,0,0,0,0,0,5
5121,1,0,0,0,0,0,0,1
5122,1,0,0,0,0,0,0,1
5123,2,0,0,0,0,0,0,2
5124,1,0,0,0,0,0,0,1
5125,1,0,0,0,0,0,0,1
5126,2,0,0,0,0,0,0,2
5130,1,0,0,0,0,0,0,1
5132,0,0,1,0,0,0,0,1
5133,0,0,1,0,0,0,0,1
5135,1,0,0,0,0,0,0,1
5136,1,0,0,0,0,0,0,1
5137,1,0,0,0,0,0,0,1
5140,1,0,0,0,0,0,0,1
5142,1,0,0,0,0,0,0,1
5149,1,0,0,0,0,0,0,1
5151,1,0,0,0,0,0,0,1
5153,1,0,0,0,0,0,0,1
5156,1,0,0,0,0,0,0,1
5158,1,0,0,0,0,0,0,1
5160,2,0,0,0,0,0,0,2
5169,1,0,0,0,0,0,0,1
5173,1,0,1,0,0,0,0,2
5174,1,0,0,0,0,0,0,1
5177,1,0,0,0,0,0,0,1
5179,2,0,0,0,0,0,0,2
5180,2,0,0,0,0,0,0,2
5182,1,0,0,0,0,0,0,1
5185,1,0,0,0,0,0,0,1
5186,1,0,0,0,0,0,0,1
5189,0,1,0,0,0,0,0,1
5190,1,0,0,0,0,0,0,1
5192,0,0,0,0,0,1,0,1
5194,1,0,0,0,0,0,0,1
5197,3,0,0,0,0,0,0,3
5200,5,0,1,0,0,0,0,6
5201,1,0,0,0,0,0,0,1
5208,2,0,0,0,0,0,0,2
5209,1,0,0,0,0,0,0,1
5215,1,0,0,0,0,0,0,1
5216,3,0,0,0,0,0,0,3
5217,1,0,0,0,0,0,0,1
5219,1,0,0,0,0,0,0,1
5221,1,0,0,0,0,0,0,1
5222,1,0,0,0,0,0,0,1
5226,1,0,0,0,0,0,0,1
5233,1,0,0,0,0,0,0,1
5236,1,0,0,0,0,0,0,1
5238,1,0,0,0,0,1,0,2
5240,3,0,1,0,0,0,0,4
5241,0,0,1,0,0,0,0,1
5243,1,0,0,0,0,0,0,1
5245,1,0,0,0,0,0,0,1
5247,2,0,0,0,0,0,0,2
5249,1,0,0,0,0,0,0,1
5250,1,0,0,0,0,0,0,1
5251,1,0,0,0,0,0,0,1
5252,2,0,0,0,0,0,0,2
5255,1,0,0,0,0,0,0,1
5256,2,0,0,0,0,0,0,2
5257,0,0,0,0,0,1,0,1
5260,1,0,0,0,0,0,0,1
5262,1,0,0,0,0,0,0,1
5265,2,0,0,0,0,0,0,2
5268,1,0,0,0,0,0,0,1
5270,2,0,0,0,0,0,0,2
5271,2,0,0,0,0,0,0,2
5272,1,0,0,0,0,0,0,1
5275,0,0,0,0,0,1,0,1
5278,3,0,0,0,0,0,0,3
5280,10,0,2,0,0,1,0,13
5281,0,0,0,0,0,1,0,1
5284,1,0,0,0,0,0,0,1
5286,1,0,0,0,0,0,0,1
5290,1,1,0,0,0,0,0,2
5291,2,0,0,0,0,0,0,2
5295,2,0,0,0,0,0,0,2
5297,1,0,0,0,0,0,0,1
5303,0,0,0,0,0,1,0,1
5304,1,0,0,0,0,0,0,1
5305,0,1,0,0,0,0,0,1
5306,2,0,0,0,0,0,0,2
5308,1,0,0,0,0,1,0,2
5310,1,0,0,0,0,0,0,1
5311,1,0,0,0,0,0,0,1
5315,2,0,0,0,0,0,0,2
5317,1,0,0,0,0,0,0,1
5320,4,1,0,0,0,1,0,6
5322,1,0,0,0,0,0,0,1
5324,1,0,0,0,0,0,0,1
5326,1,1,0,0,0,0,1,3
5327,0,0,1,0,0,0,0,1
5329,1,0,0,0,0,0,0,1
5330,1,0,0,0,0,0,0,1
5331,2,0,0,0,0,0,0,2
5332,1,0,0,0,0,0,0,1
5334,1,0,0,0,0,0,0,1
5336,1,0,0,0,0,0,0,1
5338,1,0,0,0,0,0,0,1
5340,2,0,0,0,0,0,0,2
5341,3,0,0,0,0,0,0,3
5345,1,0,0,0,0,0,0,1
5346,1,0,0,0,0,0,0,1
5348,0,0,0,0,0,1,0,1
5349,1,0,0,0,0,0,0,1
5350,1,0,0,0,0,0,0,1
5352,2,0,0,0,0,0,0,2
5355,0,0,0,0,0,1,0,1
5360,6,1,0,0,0,0,0,7
5361,1,0,0,0,0,0,0,1
5362,1,0,0,0,0,0,0,1
5364,2,0,0,0,0,0,0,2
5365,1,0,0,0,0,0,0,1
5366,0,0,1,0,0,0,0,1
5370,1,0,0,0,0,0,0,1
5374,1,0,0,0,0,0,0,1
5377,1,0,0,0,0,0,0,1
5380,2,1,0,0,0,0,0,3
5385,1,0,0,0,0,0,0,1
5386,1,0,0,0,0,0,0,1
5392,2,0,0,0,0,0,0,2
5394,0,0,0,0,0,1,0,1
5399,1,0,0,0,0,0,0,1
5400,8,0,0,0,0,0,0,8
5402,2,0,0,0,0,0,0,2
5403,1,0,0,0,0,0,0,1
5404,1,0,0,0,0,0,0,1
5408,1,0,0,0,0,0,0,1
5409,2,0,0,0,0,0,0,2
5410,1,0,0,0,0,0,0,1
5413,1,0,0,0,0,0,0,1
5415,1,0,0,0,0,0,0,1
5416,3,0,0,0,0,0,0,3
5417,1,0,0,0,0,0,0,1
5421,1,0,0,0,0,0,0,1
5425,1,0,0,0,0,0,0,1
5426,0,0,0,0,0,1,0,1
5427,1,0,0,0,0,0,0,1
5435,3,0,0,0,0,0,0,3
5436,1,0,0,0,0,0,0,1
5439,1,0,0,0,0,0,0,1
5440,5,0,0,0,0,0,0,5
5441,1,0,0,0,0,0,0,1
5442,2,0,0,0,0,0,0,2
5443,2,0,0,0,0,0,0,2
5444,1,0,0,0,0,0,0,1
5448,1,0,0,0,0,0,0,1
5449,1,0,0,0,0,0,0,1
5452,1,0,0,0,0,0,0,1
5455,1,0,0,0,0,0,0,1
5458,1,0,0,0,0,0,0,1
5460,0,0,0,0,0,1,0,1
5462,1,0,0,0,0,0,0,1
5464,1,0,0,0,0,0,0,1
5465,1,0,0,0,0,0,0,1
5466,2,0,0,0,0,0,0,2
5470,0,0,1,0,0,0,0,1
5474,3,0,0,0,0,0,0,3
5477,0,0,1,0,0,0,0,1
5479,0,0,1,0,0,0,0,1
5480,6,1,1,0,0,0,0,8
5481,1,0,0,0,0,0,0,1
5483,1,0,0,0,0,0,0,1
5484,2,0,0,0,0,0,0,2
5485,1,0,0,0,0,0,0,1
5490,1,0,0,0,0,0,0,1
5496,1,0,0,0,0,0,0,1
5498,1,0,0,0,0,0,0,1
5499,1,0,0,0,0,0,0,1
5502,2,0,0,0,0,0,0,2
5504,0,0,0,0,0,1,0,1
5507,1,0,0,0,0,0,0,1
5508,1,0,0,0,0,0,0,1
5509,1,0,0,0,0,0,0,1
5513,1,0,0,0,0,0,0,1
5517,1,0,0,0,0,0,0,1
5518,1,0,0,0,0,0,0,1
5520,10,1,1,0,0,0,0,12
5521,1,0,0,0,0,0,0,1
5523,1,0,0,0,0,0,0,1
5524,2,0,0,0,0,0,0,2
5528,1,0,0,0,0,0,0,1
5530,2,0,0,0,0,0,0,2
5533,1,0,0,0,0,0,0,1
5538,1,0,0,0,0,0,0,1
5542,0,0,1,0,0,0,0,1
5545,2,0,0,0,0,0,0,2
5548,1,0,0,0,0,0,0,1
5550,1,0,0,0,0,0,0,1
5557,1,0,0,0,0,0,0,1
5558,1,0,0,0,0,0,0,1
5560,6,0,1,0,0,1,0,8
5562,1,0,0,0,0,0,0,1
5563,2,0,0,0,0,0,0,2
5568,0,1,1,0,0,0,0,2
5571,1,0,0,0,0,0,0,1
5574,1,0,0,0,0,0,0,1
5579,1,0,0,0,0,0,0,1
5580,1,0,0,0,0,0,0,1
5581,0,1,0,0,0,0,0,1
5584,1,0,1,0,0,0,0,2
5585,1,0,0,0,0,0,0,1
5587,1,0,0,0,0,0,0,1
5588,1,0,0,0,0,0,0,1
5590,2,0,0,0,0,0,0,2
5591,1,0,0,0,0,0,0,1
5592,1,0,0,0,0,0,0,1
5596,2,0,0,0,0,0,0,2
5599,1,0,0,0,0,0,0,1
5600,10,0,1,0,0,1,0,12
5602,1,0,0,0,0,0,0,1
5604,2,0,0,0,0,0,0,2
5605,1,0,0,0,0,0,0,1
5606,1,0,0,0,0,0,0,1
5608,1,0,0,0,0,0,0,1
5609,0,0,1,0,0,0,0,1
5611,1,0,0,0,0,0,0,1
5613,3,0,0,0,0,0,0,3
5614,1,0,0,0,0,0,0,1
5615,1,0,0,0,0,0,0,1
5616,0,0,1,0,0,0,0,1
5617,1,0,0,0,0,0,0,1
5620,1,0,0,0,0,0,0,1
5621,2,0,0,0,0,0,0,2
5623,0,0,1,0,0,0,0,1
5634,1,0,0,0,0,0,0,1
5635,1,0,0,0,0,0,0,1
5636,1,0,0,0,0,0,0,1
5637,2,0,1,0,0,0,0,3
5640,2,1,0,0,0,0,0,3
5643,1,0,0,0,0,0,0,1
5646,2,0,0,0,0,0,0,2
5647,1,0,1,0,0,0,0,2
5651,1,0,0,0,0,0,0,1
5658,1,0,0,0,0,0,0,1
5659,1,0,0,0,0,0,0,1
5660,1,0,0,0,0,0,0,1
5661,1,0,0,0,0,0,0,1
5662,1,0,0,0,0,0,0,1
5670,1,0,0,0,0,0,0,1
5673,3,0,1,0,0,0,0,4
5674,1,0,0,0,0,0,0,1
5675,1,0,0,0,0,0,0,1
5679,1,0,0,0,0,0,0,1
5680,4,1,1,0,0,0,0,6
5683,1,0,0,0,0,0,0,1
5684,1,0,1,0,0,0,0,2
5685,1,0,0,0,0,0,0,1
5686,1,0,0,0,0,0,0,1
5687,1,0,0,0,0,0,0,1
5690,1,0,0,0,0,0,0,1
5692,1,0,0,0,0,0,0,1
5695,1,0,0,0,0,0,0,1
5699,1,0,0,0,0,0,0,1
5700,2,0,0,0,0,0,0,2
5701,2,0,0,0,0,0,0,2
5702,1,0,0,0,0,0,0,1
5703,1,0,0,0,0,0,0,1
5705,0,0,1,0,0,0,0,1
5707,1,0,0,0,0,0,0,1
5708,1,0,0,0,0,0,0,1
5711,0,0,0,0,0,0,1,1
5713,1,0,0,0,0,0,0,1
5714,1,0,0,0,0,0,0,1
5715,1,0,0,0,0,0,0,1
5720,2,0,0,0,0,0,0,2
5722,0,0,2,0,0,0,0,2
5727,1,0,0,0,0,0,0,1
5732,3,0,0,0,0,0,0,3
5733,1,0,0,0,0,0,0,1
5735,0,0,0,0,0,1,0,1
5739,0,0,0,0,0,1,0,1
5741,1,0,0,0,0,0,0,1
5742,0,0,0,0,0,0,1,1
5747,1,0,0,0,0,0,0,1
5749,1,0,0,0,0,0,0,1
5752,1,0,0,0,0,0,0,1
5754,1,0,0,0,0,0,0,1
5760,6,0,1,0,0,0,0,7
5764,1,0,0,0,0,0,0,1
5765,1,0,0,0,0,0,0,1
5769,2,0,0,0,0,0,0,2
5770,2,0,0,0,0,0,0,2
5771,0,0,0,0,0,1,0,1
5772,1,0,0,0,0,0,0,1
5775,3,0,0,0,0,0,0,3
5779,1,0,0,0,0,0,0,1
5780,1,0,0,0,0,0,0,1
5788,1,0,0,0,0,0,0,1
5790,1,0,0,0,0,1,0,2
5793,1,0,0,0,0,0,0,1
5795,1,0,0,0,0,0,0,1
5796,1,0,0,0,0,0,0,1
5797,1,0,0,0,0,0,0,1
5798,0,0,1,0,0,0,0,1
5800,2,1,1,0,0,0,0,4
5806,2,0,0,0,0,0,0,2
5810,1,0,0,0,0,0,0,1
5812,1,0,0,0,0,0,0,1
5813,1,0,0,0,0,0,0,1
5817,1,0,0,0,0,0,0,1
5818,1,0,0,0,0,0,0,1
5819,1,0,0,0,0,0,0,1
5822,2,0,0,0,0,0,0,2
5825,1,0,0,0,0,0,0,1
5827,1,0,0,0,0,0,0,1
5828,1,0,0,0,0,0,0,1
5830,2,0,0,0,0,0,0,2
5832,1,0,0,0,0,0,0,1
5835,0,0,1,0,0,0,0,1
5840,7,0,1,0,0,1,0,9
5842,1,0,0,0,0,0,0,1
5843,1,0,0,0,0,0,0,1
5849,1,0,0,0,0,0,0,1
5850,0,0,1,0,0,0,0,1
5852,1,0,0,0,0,0,0,1
5856,1,0,0,0,0,0,0,1
5857,1,0,0,0,0,0,0,1
5859,1,0,0,0,0,0,0,1
5863,1,0,0,0,0,1,0,2
5867,1,0,0,0,0,0,0,1
5871,1,0,0,0,0,0,0,1
5872,3,0,0,0,0,0,0,3
5875,3,0,0,0,0,0,0,3
5880,6,1,1,0,0,0,0,8
5883,1,0,0,0,0,0,0,1
5886,1,0,0,0,0,0,0,1
5887,1,0,0,0,0,0,0,1
5892,1,0,0,0,0,0,0,1
5895,1,0,0,0,0,0,0,1
5898,1,0,0,0,0,0,0,1
5902,0,1,0,0,0,0,0,1
5903,2,0,0,0,0,0,0,2
5908,1,0,0,0,0,0,0,1
5912,0,0,1,0,0,0,0,1
5914,1,0,0,0,0,0,0,1
5916,1,0,0,0,0,0,0,1
5920,10,0,1,0,0,0,0,11
5924,2,0,0,0,0,0,0,2
5925,1,0,0,0,0,0,0,1
5928,1,0,0,0,0,0,0,1
5931,2,0,0,0,0,0,0,2
5932,1,0,0,0,0,0,0,1
5933,0,0,1,0,0,0,0,1
5936,0,0,0,0,0,1,0,1
5938,1,0,0,0,0,0,0,1
5939,1,0,0,0,0,0,0,1
5940,0,1,0,0,0,0,0,1
5946,1,0,0,0,0,0,0,1
5947,1,0,0,0,0,0,0,1
5950,2,0,0,0,0,0,0,2
5952,0,0,2,0,0,0,0,2
5954,1,0,0,0,0,0,0,1
5955,1,0,0,0,0,0,0,1
5956,1,0,0,0,0,0,0,1
5960,2,0,0,0,0,0,0,2
5961,1,0,0,0,0,0,0,1
5963,1,0,0,0,0,0,0,1
5967,1,0,0,0,0,0,0,1
5973,1,0,0,0,0,0,0,1
5975,1,0,0,0,0,0,0,1
5979,1,0,0,0,0,0,0,1
5980,1,0,0,0,0,0,0,1
5983,2,0,0,0,0,0,0,2
5986,1,0,0,0,0,0,0,1
5988,1,0,0,0,0,0,0,1
5989,1,0,0,0,0,0,0,1
5990,1,0,0,0,0,0,0,1
5993,1,0,0,0,0,0,0,1
5997,2,0,0,0,0,0,0,2
6000,7,0,1,0,0,0,0,8
6003,1,0,0,0,0,0,0,1
6004,1,0,0,0,0,0,0,1
6007,0,1,0,0,0,0,0,1
6008,1,0,0,0,0,0,0,1
6010,2,0,0,0,0,0,0,2
6015,1,0,0,0,0,0,0,1
6021,1,0,0,0,0,0,0,1
6022,0,0,0,0,0,1,0,1
6025,1,0,0,0,0,0,0,1
6026,1,0,0,0,0,0,0,1
6028,1,0,0,0,0,0,0,1
6030,1,0,0,0,0,0,0,1
6031,1,0,0,0,0,0,0,1
6034,1,0,1,0,0,0,0,2
6035,1,0,0,0,0,0,0,1
6039,1,0,0,0,0,0,0,1
6040,2,0,0,0,0,0,0,2
6042,2,0,0,0,0,0,0,2
6045,1,0,0,0,0,0,0,1
6046,1,0,0,0,0,0,0,1
6047,2,0,0,0,0,0,0,2
6050,1,0,0,0,0,0,0,1
6055,1,0,0,0,0,0,0,1
6060,0,0,1,0,0,0,0,1
6065,1,0,0,0,0,0,0,1
6066,1,0,1,0,0,0,0,2
6074,1,0,0,0,0,0,0,1
6080,9,0,0,0,0,0,0,9
6084,1,0,0,0,0,0,0,1
6088,1,0,0,0,0,0,0,1
6090,0,1,0,0,0,0,0,1
6100,1,0,0,0,0,0,0,1
6101,1,0,1,0,0,0,0,2
6103,2,0,0,0,0,0,0,2
6106,1,0,0,0,0,0,0,1
6111,1,0,0,0,0,0,0,1
6113,1,0,0,0,0,0,0,1
6115,1,0,0,0,0,0,0,1
6117,1,0,0,0,0,0,0,1
6120,1,0,0,0,0,2,0,3
6125,1,0,0,0,0,0,0,1
6127,1,0,0,0,0,0,0,1
6130,1,0,0,0,0,0,0,1
6142,1,0,0,0,0,0,0,1
6143,1,0,0,0,0,0,0,1
6149,1,0,0,0,0,0,0,1
6150,1,0,0,0,0,0,0,1
6151,1,0,0,0,0,0,0,1
6153,1,0,0,0,0,0,0,1
6156,0,0,0,0,0,1,0,1
6159,1,0,0,0,0,0,0,1
6160,12,0,1,0,0,0,1,14
6164,1,0,0,0,0,0,0,1
6166,0,1,0,0,0,0,0,1
6167,1,0,0,0,0,0,0,1
6168,1,0,0,0,0,0,0,1
6170,1,0,0,0,0,0,0,1
6178,1,0,0,0,0,0,0,1
6179,1,0,0,0,0,0,0,1
6181,1,0,0,0,0,0,0,1
6188,1,0,0,0,0,0,0,1
6195,1,0,0,0,0,0,0,1
6198,2,0,0,0,0,0,0,2
6200,4,0,1,0,0,2,0,7
6202,1,0,0,0,0,0,0,1
6205,1,0,0,0,0,0,0,1
6207,1,0,0,0,0,0,0,1
6210,1,0,0,0,0,0,0,1
6214,2,0,0,0,0,0,0,2
6215,1,0,0,0,0,0,0,1
6220,1,0,0,0,0,0,0,1
6225,1,0,0,0,0,0,0,1
6227,1,0,0,0,0,0,0,1
6235,1,0,0,0,0,0,0,1
6237,1,0,0,0,0,0,0,1
6240,12,0,1,0,0,1,0,14
6244,2,0,0,0,0,0,0,2
6250,2,0,0,0,0,0,0,2
6253,1,0,0,0,0,0,0,1
6255,1,0,0,0,0,0,0,1
6259,2,0,0,0,0,0,0,2
6260,0,0,1,0,0,0,0,1
6263,1,0,0,0,0,0,0,1
6271,1,0,0,0,0,0,0,1
6280,2,1,0,0,0,0,0,3
6284,1,0,0,0,0,0,0,1
6286,1,0,0,0,0,0,0,1
6291,2,0,0,0,0,0,0,2
6297,2,0,0,0,0,0,0,2
6300,2,0,0,0,0,0,0,2
6307,1,0,0,0,0,0,0,1
6314,2,0,0,0,0,0,0,2
6316,1,0,0,0,0,0,0,1
6318,2,0,0,0,0,0,0,2
6320,7,2,0,0,0,1,0,10
6325,1,0,0,0,0,0,0,1
6328,1,0,0,0,0,0,0,1
6331,2,0,0,0,0,0,0,2
6334,1,0,0,0,0,0,0,1
6336,1,0,0,0,0,0,0,1
6337,1,0,0,0,0,0,0,1
6338,1,0,0,0,0,0,0,1
6342,1,0,0,0,0,0,0,1
6343,1,0,0,0,0,0,0,1
6345,2,0,0,0,0,0,0,2
6346,1,0,0,0,0,0,0,1
6348,1,0,0,0,0,0,0,1
6354,1,0,0,0,0,0,0,1
6357,1,0,0,0,0,0,0,1
6360,4,2,0,0,0,0,0,6
6367,1,0,0,0,0,0,0,1
6370,2,0,0,0,0,0,0,2
6371,1,0,0,0,0,0,0,1
6377,1,0,0,0,0,0,0,1
6379,0,0,0,0,0,1,0,1
6380,1,1,0,0,0,0,0,2
6388,1,0,0,0,0,0,0,1
6389,0,0,1,0,0,0,0,1
6390,1,0,0,0,0,0,0,1
6393,1,0,0,0,0,0,0,1
6396,2,0,0,0,0,0,0,2
6399,1,0,0,0,0,0,0,1
6400,9,0,1,0,0,0,0,10
6404,1,0,0,0,0,0,0,1
6409,1,0,0,0,0,0,0,1
6412,1,0,0,0,0,0,0,1
6414,1,0,0,0,0,0,0,1
6419,1,0,0,0,0,0,0,1
6420,1,0,0,0,0,0,0,1
6425,1,0,0,0,0,0,0,1
6426,1,0,1,0,0,0,0,2
6429,1,0,0,0,0,0,0,1
6432,1,0,0,0,0,0,0,1
6433,1,0,0,0,0,0,0,1
6440,3,1,0,0,0,0,0,4
6442,1,0,0,0,0,0,0,1
6444,2,0,0,0,0,0,0,2
6446,1,0,0,0,0,0,0,1
6449,0,0,1,0,0,0,0,1
6454,1,0,0,0,0,0,0,1
6462,1,0,0,0,0,0,0,1
6471,2,0,0,0,0,0,0,2
6474,1,0,0,0,0,0,0,1
6476,1,0,0,0,0,0,0,1
6479,1,0,0,0,0,0,0,1
6480,3,2,0,0,0,1,0,6
6484,1,0,0,0,0,0,0,1
6487,1,0,0,0,0,0,0,1
6490,1,0,0,0,0,0,0,1
6493,1,0,0,0,0,0,0,1
6497,0,0,0,0,0,0,1,1
6504,1,0,0,0,0,0,0,1
6505,2,0,0,0,0,0,0,2
6512,1,0,0,0,0,0,0,1
6514,1,0,1,0,0,0,0,2
6515,1,0,0,0,0,0,0,1
6517,1,0,0,0,0,0,0,1
6520,1,0,1,0,0,0,0,2
6522,1,0,0,0,0,0,0,1
6525,2,0,0,0,0,0,0,2
6527,1,0,0,0,0,0,0,1
6528,1,0,0,0,0,0,0,1
6529,1,0,0,0,0,0,0,1
6536,1,0,0,0,0,0,0,1
6539,1,0,0,0,0,0,0,1
6540,1,0,0,0,0,0,0,1
6541,2,0,0,0,0,0,0,2
6544,1,0,0,0,0,0,0,1
6547,1,0,0,0,0,0,0,1
6548,1,0,0,0,0,0,0,1
6549,1,0,0,0,0,0,0,1
6554,1,0,0,0,0,0,0,1
6555,2,0,0,0,0,0,0,2
6559,1,0,0,0,0,0,0,1
6560,7,0,0,0,0,0,0,7
6563,1,1,0,0,0,0,0,2
6565,2,0,0,0,0,0,0,2
6567,1,0,0,0,0,0,0,1
6570,0,0,1,0,0,0,0,1
6573,1,0,0,0,0,0,0,1
6574,1,0,0,0,0,0,0,1
6576,1,0,0,0,0,0,0,1
6578,1,0,0,0,0,0,0,1
6583,2,0,0,0,0,0,0,2
6585,1,0,0,0,0,0,0,1
6586,1,0,0,0,0,0,0,1
6588,1,0,0,0,0,0,0,1
6590,1,0,0,0,0,0,0,1
6592,0,0,0,0,0,1,0,1
6596,1,0,0,0,0,0,0,1
6600,12,0,2,0,0,0,0,14
6601,1,0,0,0,0,0,0,1
6604,2,0,0,0,0,0,0,2
6606,1,0,0,0,0,0,0,1
6609,3,0,0,0,0,0,0,3
6611,1,0,0,0,0,0,0,1
6617,1,0,0,0,0,0,0,1
6619,0,1,0,0,0,0,0,1
6621,1,0,0,0,0,0,0,1
6622,1,0,0,0,0,0,0,1
6628,1,0,0,0,0,0,0,1
6632,1,0,0,0,0,0,0,1
6639,1,0,0,0,0,0,0,1
6640,2,0,0,0,0,0,0,2
6643,0,1,0,0,0,0,0,1
6645,1,0,0,0,0,0,0,1
6647,1,0,0,0,0,0,0,1
6656,1,0,0,0,0,0,0,1
6668,1,0,1,0,0,0,0,2
6671,1,0,0,0,0,0,0,1
6674,1,0,0,0,0,0,0,1
6675,1,0,0,0,0,0,0,1
6680,3,0,0,0,0,0,0,3
6685,0,0,1,0,0,0,0,1
6686,2,0,0,0,0,0,0,2
6688,1,0,0,0,0,0,0,1
6691,0,1,0,0,0,0,0,1
6694,0,0,1,0,0,0,0,1
6702,1,0,0,0,0,0,0,1
6704,1,0,0,0,0,0,0,1
6706,1,0,0,0,0,0,0,1
6709,1,0,0,0,0,0,0,1
6717,1,0,0,0,0,0,0,1
6720,3,0,0,0,0,0,0,3
6722,1,0,0,0,0,0,0,1
6723,2,0,0,0,0,0,0,2
6732,1,0,0,0,0,0,0,1
6736,1,0,0,0,0,0,0,1
6737,1,0,0,0,0,0,0,1
6753,1,0,0,0,0,0,0,1
6755,1,0,0,0,0,0,0,1
6756,1,0,0,0,0,0,0,1
6759,2,0,0,0,0,0,0,2
6760,1,0,0,0,0,0,0,1
6762,0,0,0,0,1,0,0,1
6763,1,0,0,0,0,0,0,1
6765,1,0,0,0,0,0,0,1
6772,1,0,0,0,0,0,0,1
6773,1,0,0,0,0,0,0,1
6775,1,0,0,0,0,0,0,1
6782,1,0,0,0,0,0,0,1
6790,1,0,0,0,0,0,0,1
6791,1,0,0,0,0,0,0,1
6795,1,0,0,0,0,0,0,1
6796,1,0,0,0,0,0,0,1
6798,0,0,1,0,0,0,0,1
6800,6,1,0,0,0,0,0,7
6802,1,0,0,0,0,0,0,1
6816,0,0,1,0,0,0,0,1
6818,1,0,0,0,0,0,0,1
6820,1,0,0,0,0,0,0,1
6822,1,0,0,0,0,0,0,1
6832,1,0,0,0,0,0,0,1
6833,2,0,0,0,0,0,0,2
6836,1,0,0,0,0,0,0,1
6840,9,1,0,0,0,0,0,10
6851,1,0,0,0,0,0,0,1
6859,1,0,0,0,0,0,0,1
6861,1,0,0,0,0,0,0,1
6873,1,0,0,0,0,0,0,1
6874,2,0,0,0,0,0,0,2
6876,1,0,0,0,0,0,0,1
6880,6,0,0,0,0,0,0,6
6887,1,0,0,0,0,0,0,1
6889,2,0,0,0,0,0,0,2
6890,1,0,0,0,0,0,0,1
6891,1,0,0,0,0,0,0,1
6893,1,0,0,0,0,0,0,1
6898,1,0,0,0,0,0,0,1
6902,1,0,0,0,0,0,0,1
6906,1,0,0,0,0,0,0,1
6907,1,0,0,0,0,0,0,1
6911,1,0,0,0,0,0,0,1
6920,2,0,0,0,0,0,0,2
6939,1,0,0,0,0,0,0,1
6950,1,0,0,0,0,0,0,1
6954,0,1,0,0,0,0,0,1
6956,2,0,0,0,0,0,0,2
6960,9,0,3,0,0,0,0,12
6961,1,0,0,0,0,0,0,1
6967,1,0,0,0,0,0,0,1
6972,1,0,0,0,0,0,0,1
6974,1,0,0,0,0,0,0,1
6976,1,0,0,0,0,0,0,1
6980,1,0,0,0,0,0,0,1
6981,1,0,0,0,0,0,0,1
6985,1,0,0,0,0,0,0,1
6990,1,0,0,0,0,0,0,1
6993,1,0,0,0,0,0,0,1
6994,1,0,0,0,0,0,0,1
7000,3,0,0,0,0,0,0,3
7003,1,0,0,0,0,0,0,1
7011,1,0,0,0,0,0,0,1
7015,1,0,0,0,0,0,0,1
7017,1,0,0,0,0,0,0,1
7020,1,0,0,0,0,0,0,1
7032,2,0,0,0,0,0,0,2
7040,9,1,1,0,0,0,0,11
7056,1,0,0,0,0,0,0,1
7057,1,0,0,0,0,0,0,1
7058,1,0,0,0,0,0,0,1
7068,1,0,0,0,0,0,0,1
7077,1,0,0,0,0,0,0,1
7078,1,0,0,0,0,0,0,1
7080,2,0,1,0,0,0,0,3
7086,1,0,0,0,0,0,0,1
7091,1,0,0,0,0,0,0,1
7093,1,0,0,0,0,0,0,1
7101,2,0,0,0,0,0,0,2
7103,1,0,0,0,0,0,0,1
7106,1,0,0,0,0,0,0,1
7110,1,0,0,0,0,0,0,1
7119,1,0,0,0,0,0,0,1
7120,3,0,2,0,0,0,0,5
7123,1,0,0,0,0,0,0,1
7125,1,0,0,0,0,0,0,1
7126,1,0,0,0,0,0,0,1
7130,1,0,0,0,0,0,0,1
7132,1,0,0,0,0,0,0,1
7139,1,0,0,0,0,0,0,1
7154,1,0,0,0,0,0,0,1
7160,2,0,0,0,0,0,0,2
7161,1,0,0,0,0,0,0,1
7162,1,0,0,0,0,0,0,1
7179,2,0,0,0,0,0,0,2
7182,1,0,0,0,0,0,0,1
7186,1,0,0,0,0,0,0,1
7188,1,0,0,0,0,0,0,1
7199,1,0,0,0,0,0,0,1
7200,6,0,1,0,0,0,0,7
7206,1,0,0,0,0,0,0,1
7214,1,0,0,0,0,0,0,1
7221,1,0,0,0,0,0,0,1
7229,1,0,0,0,0,0,0,1
7233,0,0,0,0,0,1,0,1
7237,1,0,0,0,0,0,0,1
7240,3,0,0,0,0,0,0,3
7241,1,0,0,0,0,0,0,1
7243,1,0,0,0,0,0,0,1
7244,2,0,0,0,0,0,0,2
7248,1,0,0,0,0,0,0,1
7250,1,0,0,0,0,0,0,1
7253,1,0,0,0,0,0,0,1
7254,1,0,0,0,0,0,0,1
7258,1,0,0,0,0,0,0,1
7260,1,0,0,0,0,0,0,1
7262,1,0,0,0,0,0,0,1
7267,1,0,0,0,0,0,0,1
7268,1,0,0,0,0,0,0,1
7269,1,0,0,0,0,0,0,1
7272,1,0,0,0,0,0,0,1
7275,1,0,0,0,0,0,0,1
7280,7,0,0,0,0,1,0,8
7283,1,0,0,0,0,0,0,1
7285,1,0,0,0,0,0,0,1
7297,3,0,0,0,0,0,0,3
7306,1,0,0,0,0,0,0,1
7314,1,0,0,0,0,0,0,1
7318,1,0,0,0,0,0,0,1
7320,4,0,2,0,0,0,0,6
7333,1,0,0,0,0,0,0,1
7343,1,0,0,0,0,0,0,1
7348,1,0,0,0,0,0,0,1
7350,1,0,0,0,0,0,0,1
7358,1,0,0,0,0,0,0,1
7360,8,1,1,0,0,0,0,10
7361,1,0,0,0,0,0,0,1
7363,1,0,0,0,0,0,0,1
7364,1,0,0,0,0,0,0,1
7367,0,0,1,0,0,0,0,1
7374,1,0,0,0,0,0,0,1
7379,1,0,0,0,0,0,0,1
7380,1,0,0,0,0,0,0,1
7383,1,0,0,0,0,0,0,1
7392,0,1,0,0,0,0,0,1
7400,3,0,0,0,0,0,0,3
7402,1,0,0,0,0,0,0,1
7406,0,0,1,0,0,0,0,1
7413,1,0,0,0,0,0,0,1
7414,1,0,0,0,0,0,0,1
7416,3,0,0,0,0,0,0,3
7420,1,0,0,0,0,0,0,1
7421,1,0,0,0,0,0,0,1
7423,1,0,0,0,0,0,0,1
7426,0,0,1,0,0,0,0,1
7440,5,0,0,0,0,0,0,5
7443,0,0,1,0,0,0,0,1
7444,2,0,0,0,0,1,0,3
7447,1,0,0,0,0,0,0,1
7456,1,0,0,0,0,0,0,1
7461,0,1,0,0,0,0,0,1
7462,1,0,0,0,0,0,0,1
7467,1,0,0,0,0,0,0,1
7473,1,0,0,0,0,0,0,1
7478,1,0,0,0,0,0,0,1
7480,1,0,0,0,0,0,0,1
7481,1,0,0,0,0,0,0,1
7487,2,0,0,0,0,0,0,2
7491,1,0,0,0,0,0,0,1
7494,1,0,0,0,0,0,0,1
7497,1,0,0,0,0,0,0,1
7507,1,0,0,0,0,0,0,1
7520,6,0,0,0,0,0,0,6
7529,1,0,0,0,0,0,0,1
7532,1,0,0,0,0,0,0,1
7540,1,0,0,0,0,0,0,1
7541,1,0,0,0,0,0,0,1
7549,0,0,1,0,0,0,0,1
7550,1,0,0,0,0,0,0,1
7552,1,0,0,0,0,0,0,1
7560,3,1,0,0,0,0,0,4
7567,1,0,0,0,0,0,0,1
7572,1,0,0,0,0,0,0,1
7573,0,0,0,0,0,1,0,1
7577,1,0,0,0,0,0,0,1
7579,1,0,0,0,0,0,0,1
7580,1,0,0,0,0,0,0,1
7581,1,0,0,0,0,0,0,1
7582,2,0,0,0,0,0,0,2
7600,3,0,0,0,0,0,0,3
7605,1,0,0,0,0,0,0,1
7610,1,0,0,0,0,0,0,1
7613,1,0,0,0,0,0,0,1
7625,1,0,0,0,0,0,0,1
7632,0,0,1,0,0,0,0,1
7640,3,0,0,0,0,0,0,3
7647,1,0,0,0,0,0,0,1
7648,1,0,0,0,0,0,0,1
7652,0,1,0,0,0,0,0,1
7655,1,0,0,0,0,0,0,1
7673,1,0,0,0,0,0,0,1
7677,1,0,0,0,0,0,0,1
7678,1,1,0,0,0,0,0,2
7680,5,0,0,0,0,0,0,5
7685,1,0,0,0,0,0,0,1
7689,1,0,0,0,0,0,0,1
7696,0,0,0,0,0,1,0,1
7698,1,0,0,0,0,0,0,1
7702,2,0,0,0,0,0,0,2
7705,1,0,0,0,0,0,0,1
7719,0,0,0,0,0,1,0,1
7720,3,0,0,0,0,1,0,4
7723,1,0,0,0,0,0,0,1
7724,1,0,0,0,0,0,0,1
7740,0,0,1,0,0,0,0,1
7742,1,0,0,0,0,0,0,1
7747,1,0,0,0,0,0,0,1
7750,0,0,1,0,0,0,0,1
7752,1,0,0,0,0,0,0,1
7758,1,0,0,0,0,0,0,1
7760,3,0,0,0,0,0,0,3
7772,1,0,0,0,0,0,0,1
7778,1,0,0,0,0,0,0,1
7785,1,0,0,0,0,0,0,1
7786,2,0,0,0,0,0,0,2
7795,1,0,0,0,0,0,0,1
7800,3,1,1,0,0,0,0,5
7801,1,0,0,0,0,0,0,1
7802,1,0,0,0,0,0,0,1
7808,1,0,0,0,0,0,0,1
7815,1,0,0,0,0,0,0,1
7819,1,0,0,0,0,0,0,1
7831,1,0,0,0,0,0,0,1
7840,3,0,0,0,0,0,0,3
7844,0,0,1,0,0,0,0,1
7846,1,0,0,0,0,0,0,1
7852,1,0,0,0,0,0,0,1
7853,1,0,0,0,0,0,0,1
7859,1,0,0,0,0,0,0,1
7862,1,0,0,0,0,0,1,2
7863,2,0,0,0,0,0,0,2
7868,1,0,0,0,0,0,0,1
7869,0,0,0,1,0,0,0,1
7875,0,0,1,0,0,0,0,1
7877,0,1,0,0,0,0,0,1
7878,1,0,0,0,0,0,0,1
7880,1,0,0,0,0,0,0,1
7886,1,0,0,0,0,0,0,1
7887,1,0,0,0,0,0,0,1
7889,1,0,0,0,0,0,0,1
7894,1,0,0,0,0,0,0,1
7911,1,0,0,0,0,0,0,1
7917,1,0,0,0,0,0,0,1
7918,0,0,1,0,0,0,0,1
7920,3,0,0,0,0,0,0,3
7929,1,0,0,0,0,0,0,1
7938,1,0,0,0,0,0,0,1
7940,1,0,0,0,0,0,0,1
7950,2,0,0,0,0,0,0,2
7951,1,0,0,0,0,0,0,1
7960,5,0,0,0,0,0,0,5
7973,1,0,0,0,0,0,0,1
7978,1,0,0,0,0,0,0,1
7980,2,0,0,0,0,0,0,2
7984,1,0,0,0,0,0,0,1
7990,1,0,0,0,0,0,0,1
7993,1,0,0,0,0,0,0,1
7996,2,0,0,0,0,0,0,2
8000,5,1,1,0,0,0,0,7
8011,1,0,0,0,0,0,0,1
8014,1,0,0,0,0,0,0,1
8016,1,0,0,0,0,0,0,1
8028,1,0,0,0,0,0,0,1
8035,1,0,0,0,0,0,0,1
8040,6,0,0,0,0,0,0,6
8042,0,0,0,1,0,0,0,1
8043,1,0,0,0,0,0,0,1
8045,1,0,0,0,0,0,0,1
8050,1,0,0,0,0,0,0,1
8054,1,0,0,0,0,0,0,1
8058,1,0,0,0,0,0,0,1
8064,1,0,0,0,0,0,0,1
8066,1,0,0,0,0,0,0,1
8067,1,0,0,0,0,0,0,1
8078,1,0,0,0,0,0,0,1
8079,0,0,1,0,0,0,0,1
8080,4,1,2,0,0,0,0,7
8091,2,0,0,0,0,0,0,2
8105,1,0,0,0,0,0,0,1
8120,2,0,0,0,0,0,0,2
8144,2,0,0,0,0,0,0,2
8153,0,1,0,0,0,0,0,1
8155,0,0,1,0,0,0,0,1
8158,1,0,0,0,0,0,0,1
8160,3,1,0,0,0,0,0,4
8161,1,0,0,0,0,0,0,1
8163,1,0,0,0,0,1,0,2
8166,1,0,0,0,0,0,0,1
8168,1,0,0,0,0,0,0,1
8196,1,0,0,0,0,0,0,1
8200,1,0,0,0,0,0,0,1
8210,1,0,0,0,0,0,0,1
8220,1,0,0,0,1,0,0,2
8240,8,0,1,0,0,0,0,9
8256,1,0,0,0,0,0,0,1
8258,1,0,0,0,0,0,0,1
8261,1,0,0,0,0,0,0,1
8266,1,0,0,0,0,0,0,1
8279,0,0,0,0,1,0,0,1
8280,2,0,1,0,0,0,0,3
8296,1,0,0,0,0,0,0,1
8297,1,0,0,0,0,0,0,1
8301,0,0,0,0,0,1,0,1
8306,1,0,0,0,0,0,0,1
8319,2,0,0,0,0,0,0,2
8320,4,0,1,0,0,0,0,5
8322,1,0,0,0,0,0,0,1
8325,1,0,0,0,0,0,0,1
8326,1,0,0,0,0,0,0,1
8329,1,0,0,0,0,0,0,1
8348,1,0,0,0,0,0,0,1
8360,4,0,0,0,0,0,0,4
8371,1,0,0,0,0,0,0,1
8372,0,1,0,0,0,0,0,1
8378,0,0,1,0,0,0,0,1
8384,1,0,0,0,0,0,0,1
8392,1,0,0,0,0,0,0,1
8400,6,0,1,0,0,0,0,7
8402,1,0,0,0,0,0,0,1
8413,0,0,1,0,0,0,0,1
8416,1,0,0,0,0,0,0,1
8417,1,0,0,0,0,0,0,1
8425,1,0,0,0,0,0,0,1
8440,3,0,0,0,0,1,0,4
8442,1,0,0,0,0,0,0,1
8444,1,0,0,0,0,0,0,1
8450,1,0,0,0,0,0,0,1
8453,0,0,1,0,0,0,0,1
8469,1,0,0,0,0,0,0,1
8471,1,0,0,0,0,0,0,1
8479,1,0,0,0,0,0,0,1
8480,10,1,2,0,0,0,0,13
8489,1,0,0,0,0,0,0,1
8491,1,0,0,0,0,0,0,1
8500,1,0,0,0,0,0,0,1
8513,1,0,0,0,0,0,0,1
8514,1,0,0,0,0,0,0,1
8520,4,0,0,0,0,0,0,4
8522,1,0,0,0,0,0,0,1
8533,1,0,0,0,0,0,0,1
8541,1,0,0,0,0,0,0,1
8550,1,0,0,0,0,0,0,1
8554,1,0,0,0,0,0,0,1
8557,1,0,0,0,0,0,0,1
8560,6,0,0,0,0,0,0,6
8573,1,0,0,0,0,0,0,1
8579,1,0,0,0,0,0,0,1
8581,1,0,0,0,0,0,0,1
8584,1,0,0,0,0,0,0,1
8593,1,0,0,0,0,0,0,1
8600,1,0,0,0,0,0,0,1
8604,1,0,0,0,0,0,0,1
8610,2,0,0,0,0,0,0,2
8612,1,0,0,0,0,0,0,1
8614,1,0,0,0,0,0,0,1
8621,1,0,0,0,0,0,0,1
8625,0,0,1,0,0,0,0,1
8627,1,0,0,0,0,0,0,1
8635,1,0,0,0,0,0,0,1
8640,5,0,0,0,0,0,0,5
8645,1,0,0,0,0,0,0,1
8649,0,0,1,0,0,0,0,1
8664,1,0,0,0,0,0,0,1
8670,1,0,0,0,0,0,0,1
8674,1,0,0,0,0,0,0,1
8677,1,0,0,0,0,0,0,1
8680,3,0,0,0,0,0,0,3
8689,1,0,0,0,0,0,0,1
8692,1,0,0,0,0,0,0,1
8695,1,0,0,0,0,0,0,1
8700,1,0,0,0,0,0,0,1
8704,0,0,1,0,0,0,0,1
8711,1,0,0,0,0,0,0,1
8720,4,1,1,0,0,0,0,6
8722,1,0,0,0,0,0,0,1
8726,0,0,0,0,0,1,0,1
8730,1,0,0,0,0,0,0,1
8751,1,0,0,0,0,0,0,1
8755,1,0,0,0,0,0,0,1
8757,1,0,0,0,0,0,0,1
8758,1,0,0,0,0,0,0,1
8760,4,0,1,0,0,0,0,5
8767,1,0,0,0,0,0,0,1
8770,1,0,0,0,0,0,0,1
8774,1,0,0,0,0,0,0,1
8777,1,0,0,0,0,0,0,1
8789,1,0,0,0,0,0,0,1
8790,1,0,0,0,0,0,0,1
8795,1,0,0,0,0,0,0,1
8797,1,0,0,0,0,0,0,1
8800,9,1,0,0,0,0,0,10
8808,1,0,0,0,0,0,0,1
8813,1,0,0,0,0,0,0,1
8820,2,0,0,0,0,0,0,2
8822,1,0,0,0,0,0,0,1
8831,1,0,0,0,0,0,0,1
8840,2,0,0,0,0,0,0,2
8843,1,0,0,0,0,0,0,1
8864,1,0,0,0,0,0,0,1
8866,1,0,0,0,0,0,0,1
8874,1,0,0,0,0,0,0,1
8880,10,0,0,0,0,0,0,10
8882,1,0,0,0,0,0,0,1
8886,1,0,0,0,0,0,0,1
8887,1,0,0,0,0,0,0,1
8891,0,0,0,0,1,0,0,1
8899,0,0,0,1,0,0,0,1
8903,1,0,0,0,0,0,0,1
8904,1,0,0,0,0,0,0,1
8907,1,0,0,0,0,0,0,1
8911,1,0,0,0,0,0,0,1
8912,1,0,0,0,0,0,0,1
8917,1,0,0,0,0,0,0,1
8920,1,0,0,0,0,0,0,1
8926,1,0,0,0,0,0,0,1
8928,0,0,0,0,0,1,0,1
8929,1,0,0,0,0,0,0,1
8931,1,0,0,0,0,0,0,1
8933,1,0,0,0,0,0,0,1
8935,2,0,0,0,0,0,0,2
8938,1,0,0,0,0,0,0,1
8960,6,0,0,0,0,0,0,6
8961,1,0,0,0,0,0,0,1
8967,1,0,0,0,0,0,0,1
9000,2,1,0,0,0,0,0,3
9014,1,0,0,0,0,0,0,1
9023,0,0,1,0,0,0,0,1
9025,0,0,0,0,1,0,0,1
9037,1,0,0,0,0,0,0,1
9039,1,0,0,0,0,0,0,1
9040,7,0,0,0,0,0,0,7
9046,1,0,0,0,0,0,0,1
9049,1,0,0,0,0,0,0,1
9056,1,0,0,0,0,0,0,1
9061,1,0,0,0,0,0,0,1
9069,1,0,0,0,0,0,0,1
9073,1,0,0,0,0,0,0,1
9076,1,0,0,0,0,0,0,1
9078,1,0,0,0,0,0,0,1
9080,1,0,1,0,0,0,0,2
9084,0,0,1,0,0,0,0,1
9085,1,0,0,0,0,0,0,1
9090,1,0,0,0,0,0,0,1
9092,1,0,0,0,0,0,0,1
9098,1,0,0,0,0,0,0,1
9107,1,0,0,0,0,0,0,1
9110,1,0,0,0,0,0,0,1
9111,1,0,0,0,0,0,0,1
9114,1,0,0,0,0,0,0,1
9119,2,0,0,0,0,0,0,2
9120,7,0,1,0,0,0,0,8
9126,2,0,0,0,0,0,0,2
9127,1,0,0,0,0,0,0,1
9139,1,0,0,0,0,0,0,1
9155,1,0,0,0,0,0,0,1
9160,3,1,0,0,0,0,0,4
9165,1,0,0,0,0,0,0,1
9168,0,1,0,0,0,0,0,1
9198,2,0,0,0,0,0,0,2
9200,3,0,0,0,0,0,0,3
9206,1,0,0,0,0,0,0,1
9212,1,0,0,0,0,0,0,1
9216,1,0,0,0,0,0,0,1
9217,1,0,0,0,0,0,0,1
9227,1,0,0,0,0,0,0,1
9229,1,0,0,0,0,0,0,1
9240,1,0,0,0,0,0,0,1
9243,1,0,0,0,0,0,0,1
9246,1,0,0,0,0,0,0,1
9271,1,0,0,0,0,0,0,1
9279,1,0,0,0,0,0,0,1
9280,5,0,1,0,0,0,0,6
9295,2,0,0,0,0,0,0,2
9300,1,0,0,0,0,0,0,1
9320,3,0,0,0,0,0,0,3
9322,1,0,0,0,0,0,0,1
9323,0,0,0,0,1,0,0,1
9332,1,0,0,0,0,0,0,1
9333,1,0,0,0,0,0,0,1
9336,2,0,0,0,0,0,0,2
9357,1,0,0,0,0,0,0,1
9360,6,0,1,0,0,0,0,7
9365,1,0,0,0,0,0,0,1
9378,1,0,0,0,0,0,0,1
9382,1,0,0,0,0,0,0,1
9385,1,0,0,0,0,0,0,1
9393,1,0,0,0,0,0,0,1
9396,0,1,0,0,0,0,0,1
9400,1,0,0,0,0,0,0,1
9414,1,0,0,0,0,0,0,1
9421,1,0,0,0,0,0,0,1
9440,1,0,0,0,0,0,0,1
9443,1,0,0,0,0,0,0,1
9448,1,0,0,0,0,0,0,1
9450,1,0,0,0,0,0,0,1
9457,0,0,1,0,0,0,0,1
9459,1,0,0,0,0,0,0,1
9473,1,0,0,0,0,0,0,1
9481,0,1,0,0,0,0,0,1
9494,1,0,0,0,0,0,0,1
9507,1,0,0,0,0,0,0,1
9508,1,0,0,0,0,0,0,1
9520,6,0,0,0,0,0,0,6
9529,1,0,0,0,0,0,0,1
9532,1,0,0,0,0,0,0,1
9546,0,1,0,0,0,0,0,1
9560,2,0,0,0,0,0,0,2
9589,1,0,0,0,0,0,0,1
9600,6,0,0,0,0,0,0,6
9601,1,0,0,0,0,0,0,1
9602,1,0,0,0,0,0,0,1
9613,1,0,0,0,0,0,0,1
9621,1,0,0,0,0,0,0,1
9634,1,0,0,0,0,0,0,1
9635,1,0,0,0,0,0,0,1
9638,1,0,0,0,0,0,0,1
9640,2,0,0,0,0,0,0,2
9659,1,0,0,0,0,0,0,1
9668,1,0,0,0,0,0,0,1
9671,1,0,0,0,0,0,0,1
9676,1,0,0,0,0,0,0,1
9680,3,0,0,0,0,0,0,3
9695,0,1,0,0,0,0,0,1
9717,1,0,0,0,0,0,0,1
9720,5,1,0,0,0,0,0,6
9731,1,0,0,0,0,0,0,1
9736,1,0,0,0,0,0,0,1
9742,1,0,0,0,0,0,0,1
9744,1,0,0,0,0,0,0,1
9745,0,0,0,0,0,0,1,1
9760,4,0,1,0,0,0,0,5
9775,1,0,0,0,0,0,0,1
9784,1,0,0,0,0,0,0,1
9792,1,0,0,0,0,0,0,1
9795,1,0,0,0,0,0,0,1
9800,2,0,0,0,0,0,0,2
9806,1,0,0,0,0,0,0,1
9833,0,0,0,0,0,1,0,1
9835,0,1,0,0,0,0,0,1
9840,2,0,0,0,0,0,0,2
9850,1,0,0,0,0,0,0,1
9852,1,0,0,0,0,0,0,1
9855,1,0,0,0,0,0,0,1
9859,1,0,0,0,0,0,0,1
9864,1,0,0,0,0,0,0,1
9876,1,0,0,0,0,0,0,1
9900,1,1,0,0,0,0,0,2
9901,2,0,0,0,0,0,0,2
9920,6,0,0,0,0,0,0,6
9925,1,0,0,0,0,0,0,1
9939,1,0,0,0,0,0,0,1
9956,1,0,0,0,0,0,0,1
9960,2,0,1,0,0,0,0,3
9964,1,0,0,0,0,0,0,1
9984,1,0,0,0,0,0,0,1
9985,1,0,0,0,0,0,0,1
10000,3,1,1,0,0,0,0,5
10009,0,0,1,0,0,0,0,1
10010,0,0,0,0,0,1,0,1
10021,0,0,1,0,0,0,0,1
10031,1,0,0,0,0,0,0,1
10040,3,0,0,0,0,0,0,3
10044,1,0,0,0,0,0,0,1
10049,1,0,0,0,0,0,0,1
10057,1,0,0,0,0,0,0,1
10077,1,0,0,0,0,0,0,1
10080,7,0,0,0,0,0,0,7
10101,0,0,0,1,0,0,0,1
10116,1,0,0,0,0,0,0,1
10120,1,0,1,0,0,0,0,2
10128,1,0,0,0,0,0,0,1
10131,1,0,0,0,0,0,0,1
10133,1,0,0,0,0,0,0,1
10140,1,0,0,0,0,0,0,1
10157,1,0,0,0,0,0,0,1
10159,1,0,0,0,0,0,0,1
10160,4,0,1,0,0,0,0,5
10162,1,0,0,0,0,0,0,1
10170,1,0,0,0,0,0,0,1
10171,1,0,0,0,0,0,0,1
10199,1,0,0,0,0,0,0,1
10200,2,0,0,0,0,0,0,2
10201,0,0,0,0,0,1,0,1
10206,1,0,0,0,0,0,0,1
10207,1,0,0,0,0,0,0,1
10213,1,0,0,0,0,0,0,1
10237,1,0,0,0,0,0,0,1
10239,1,0,0,0,0,0,0,1
10240,5,0,0,0,0,0,0,5
10252,2,0,0,0,0,0,0,2
10280,3,0,0,0,0,0,0,3
10281,1,0,0,0,0,0,0,1
10291,1,0,0,0,0,0,0,1
10292,1,0,0,0,0,0,0,1
10306,0,0,2,0,0,0,0,2
10319,1,0,0,0,0,0,0,1
10320,7,0,1,0,0,0,0,8
10338,1,0,0,0,0,0,0,1
10360,2,0,0,0,0,0,0,2
10369,1,0,0,0,0,0,0,1
10371,1,0,0,0,0,0,0,1
10376,1,0,0,0,0,0,0,1
10386,1,0,0,0,0,0,0,1
10394,0,0,1,0,0,0,0,1
10400,4,0,0,0,0,0,0,4
10417,1,0,0,0,0,0,0,1
10420,1,0,0,0,0,0,0,1
10427,1,0,1,0,0,0,0,2
10440,6,1,0,0,0,0,0,7
10450,1,0,0,0,0,0,0,1
10455,1,0,0,0,0,0,0,1
10456,1,0,0,0,0,0,0,1
10458,1,0,0,0,0,0,0,1
10476,1,0,0,0,0,0,0,1
10479,1,0,0,0,0,0,0,1
10480,4,0,0,0,0,0,0,4
10489,1,0,0,0,0,0,0,1
10494,1,0,0,0,0,0,0,1
10500,1,0,0,0,0,0,0,1
10507,1,0,0,0,0,0,0,1
10517,1,0,0,0,0,0,0,1
10520,1,0,0,0,0,0,0,1
10521,1,0,0,0,0,0,0,1
10527,1,0,0,0,0,0,0,1
10533,0,0,0,0,1,0,0,1
10535,1,0,0,0,0,0,0,1
10560,7,0,0,0,0,0,0,7
10590,1,0,0,0,0,0,0,1
10592,1,0,0,0,0,0,0,1
10596,1,0,0,0,0,0,0,1
10600,1,0,0,0,0,0,0,1
10606,1,0,0,0,0,0,0,1
10619,1,0,0,0,0,0,0,1
10637,1,0,0,0,0,0,0,1
10640,8,0,0,0,0,1,0,9
10663,1,0,0,0,0,0,0,1
10671,1,0,0,0,0,0,0,1
10680,1,0,0,0,0,0,0,1
10695,0,0,0,0,0,1,0,1
10697,1,0,0,0,0,0,0,1
10700,1,0,0,0,0,0,0,1
10704,1,0,0,0,0,0,0,1
10718,1,0,0,0,0,0,0,1
10720,3,0,0,0,0,0,0,3
10758,2,0,0,0,0,0,0,2
10760,1,0,2,1,0,0,0,4
10773,1,0,0,0,0,0,0,1
10774,1,0,0,0,0,0,0,1
10798,1,0,0,0,0,0,0,1
10800,7,0,0,0,0,0,0,7
10805,1,0,0,0,0,0,0,1
10815,1,0,0,0,0,0,0,1
10821,1,0,0,0,0,0,0,1
10824,0,1,0,0,0,0,0,1
10840,2,0,0,0,0,0,0,2
10850,1,0,0,0,0,0,0,1
10853,1,0,0,0,0,0,0,1
10860,1,0,0,0,0,0,0,1
10880,5,0,0,0,0,0,0,5
10896,1,0,0,0,0,0,0,1
10897,1,0,0,0,0,0,0,1
10900,0,0,0,0,0,1,0,1
10901,1,0,0,0,0,0,0,1
10908,1,0,0,0,0,0,0,1
10919,1,0,0,0,0,0,0,1
10920,2,0,0,0,0,0,0,2
10931,2,0,0,0,0,0,0,2
10940,1,0,0,0,0,0,0,1
10960,1,0,0,0,0,0,0,1
10976,1,0,0,0,0,0,0,1
11000,2,0,0,0,0,0,0,2
11002,0,1,0,0,0,0,0,1
11021,1,0,0,0,0,0,0,1
11038,1,0,0,0,0,0,0,1
11040,7,1,1,0,0,0,0,9
11045,1,0,0,0,0,0,0,1
11074,1,0,0,0,0,0,0,1
11076,2,0,0,0,0,0,0,2
11077,1,0,0,0,0,0,0,1
11080,5,0,0,0,0,0,0,5
11092,1,0,0,0,0,0,0,1
11094,1,0,0,0,0,0,0,1
11103,1,0,0,0,0,0,0,1
11115,1,0,0,0,0,0,0,1
11120,3,0,0,0,0,0,0,3
11122,1,0,0,0,0,0,0,1
11134,1,0,0,0,0,0,0,1
11142,1,0,0,0,0,0,0,1
11160,7,0,0,0,0,1,0,8
11170,1,0,0,0,0,0,0,1
11194,1,0,0,0,0,0,0,1
11200,1,0,0,0,0,1,0,2
11219,0,0,1,0,0,0,0,1
11254,0,1,0,0,0,0,0,1
11269,0,0,1,0,0,0,0,1
11280,6,0,2,0,0,0,0,8
11301,1,0,0,0,0,0,0,1
11317,1,0,0,0,0,0,0,1
11324,1,0,0,0,0,0,0,1
11330,1,0,0,0,0,0,0,1
11332,0,0,0,0,0,1,0,1
11340,0,0,1,0,0,0,0,1
11342,1,0,0,0,0,0,0,1
11343,2,0,0,0,0,0,0,2
11359,1,0,0,0,0,0,0,1
11360,2,0,1,0,0,0,0,3
11370,0,0,0,0,1,0,0,1
11389,2,0,0,0,0,0,0,2
11397,1,0,0,0,0,0,0,1
11400,4,0,1,0,0,1,0,6
11403,1,0,0,0,0,0,0,1
11405,2,0,0,0,0,0,0,2
11409,0,0,1,0,0,0,0,1
11433,1,0,0,0,0,0,0,1
11440,4,0,0,0,0,0,0,4
11460,1,0,0,0,0,0,0,1
11480,1,0,1,0,0,0,0,2
11505,1,0,0,0,0,0,0,1
11508,2,0,0,0,0,0,0,2
11514,0,1,0,0,0,0,0,1
11520,6,0,0,0,0,0,0,6
11529,1,0,0,0,0,0,0,1
11532,1,0,0,0,0,0,0,1
11538,1,0,0,0,0,0,0,1
11556,1,0,0,0,0,0,0,1
11559,0,0,1,0,0,0,0,1
11560,1,0,0,0,0,0,0,1
11586,1,0,0,0,0,0,0,1
11600,2,0,0,0,0,0,0,2
11612,1,0,0,0,0,0,0,1
11614,1,0,0,0,0,0,0,1
11628,1,0,0,0,0,0,0,1
11630,1,0,0,0,0,0,0,1
11637,1,0,0,0,0,0,0,1
11640,4,0,0,0,0,0,0,4
11658,1,0,0,0,0,0,0,1
11665,0,1,0,0,0,0,0,1
11680,5,0,1,0,0,0,0,6
11685,1,0,0,0,0,0,0,1
11689,1,0,0,0,0,0,0,1
11701,1,0,0,0,0,0,0,1
11716,1,0,0,0,0,0,0,1
11720,1,0,0,0,0,0,0,1
11737,1,0,0,0,0,0,0,1
11760,3,1,0,0,0,0,0,4
11780,1,0,0,0,0,0,0,1
11804,1,0,0,0,0,0,0,1
11840,2,0,0,0,0,0,0,2
11849,0,0,0,0,1,0,0,1
11857,1,0,0,0,0,0,0,1
11880,2,0,0,0,0,0,0,2
11888,1,0,0,0,0,0,0,1
11895,1,0,0,0,0,0,0,1
11907,1,0,0,0,0,0,0,1
11912,1,0,0,0,0,0,0,1
11920,6,0,0,0,0,0,0,6
11921,1,0,0,0,0,0,0,1
11932,1,0,0,0,0,0,0,1
11960,1,0,0,0,0,0,0,1
11964,1,0,0,0,0,0,0,1
12000,6,0,3,0,0,0,0,9
12008,1,0,0,0,0,0,0,1
12028,1,0,0,0,0,0,0,1
12040,0,0,1,0,0,0,0,1
12060,0,0,1,0,0,0,0,1
12080,5,0,0,0,0,1,0,6
12111,1,0,0,0,0,0,0,1
12117,1,0,0,0,0,0,0,1
12120,1,0,0,0,0,0,0,1
12126,1,0,0,0,0,0,0,1
12137,1,0,0,0,0,0,0,1
12160,9,0,0,0,0,0,0,9
12175,1,0,0,0,0,0,0,1
12176,1,0,0,0,0,0,0,1
12187,1,0,0,0,0,0,0,1
12200,1,0,0,0,0,0,0,1
12202,0,0,0,0,0,1,0,1
12205,1,0,0,0,0,0,0,1
12206,1,0,0,0,0,0,0,1
12213,1,0,0,0,0,0,0,1
12226,1,0,0,0,0,0,0,1
12240,1,0,2,0,0,0,0,3
12248,1,0,0,0,0,0,0,1
12274,1,0,0,0,0,0,0,1
12280,1,0,0,0,0,0,0,1
12287,1,0,0,0,0,0,0,1
12306,1,0,0,0,0,0,0,1
12320,4,0,0,0,0,0,0,4
12357,1,0,0,0,0,0,0,1
12359,1,0,0,0,0,0,0,1
12360,1,1,0,0,0,0,0,2
12390,0,0,0,1,0,0,0,1
12395,1,0,0,0,0,0,0,1
12397,1,0,0,0,0,0,0,1
12400,1,0,0,0,0,0,0,1
12418,1,0,0,0,0,0,0,1
12429,1,0,0,0,0,0,0,1
12440,3,0,0,0,0,0,0,3
12453,1,0,0,0,0,0,0,1
12468,1,0,0,0,0,0,0,1
12480,4,0,0,0,0,0,0,4
12484,1,0,0,0,0,0,0,1
12491,1,0,0,0,0,0,0,1
12508,1,0,0,0,0,0,0,1
12529,1,0,0,0,0,0,0,1
12560,1,0,0,0,0,0,0,1
12584,1,0,0,0,0,0,0,1
12588,0,0,0,1,0,0,0,1
12600,2,1,0,0,0,0,0,3
12629,0,1,0,0,0,0,0,1
12631,0,0,0,1,0,0,0,1
12638,1,0,0,0,0,0,0,1
12640,3,0,1,0,0,0,0,4
12650,1,0,0,0,0,0,0,1
12680,1,0,0,0,0,0,0,1
12691,1,0,0,0,0,0,0,1
12719,1,0,0,0,0,0,0,1
12720,4,0,1,0,0,0,0,5
12724,1,0,0,0,0,0,0,1
12741,1,0,0,0,0,0,0,1
12758,1,0,0,0,0,0,0,1
12798,2,0,0,0,0,0,0,2
12834,0,0,0,0,0,1,0,1
12840,2,0,0,0,0,0,0,2
12848,1,0,0,0,0,0,0,1
12874,1,0,0,0,0,0,0,1
12880,3,0,0,0,0,0,0,3
12895,1,0,0,0,0,0,0,1
12916,0,0,1,0,0,0,0,1
12920,2,0,0,0,0,0,0,2
12932,0,1,0,0,0,0,0,1
12951,1,0,0,0,0,0,0,1
12960,4,0,0,0,0,0,0,4
12963,1,0,0,0,0,0,0,1
13000,2,0,0,0,0,0,0,2
13011,1,0,0,0,0,0,0,1
13022,1,0,0,0,0,0,0,1
13038,1,0,0,0,0,0,0,1
13040,1,0,0,0,0,0,0,1
13047,1,0,0,0,0,0,0,1
13048,1,0,0,0,0,0,0,1
13049,1,0,0,0,0,0,0,1
13053,1,0,0,0,0,0,0,1
13083,0,0,0,1,0,0,0,1
13089,1,0,0,0,0,0,0,1
13115,1,0,0,0,0,0,0,1
13120,5,1,2,0,0,0,0,8
13160,1,0,0,0,1,0,0,2
13187,1,0,0,0,0,0,0,1
13192,1,0,0,0,0,0,0,1
13200,2,0,1,0,0,0,0,3
13211,1,0,0,0,0,0,0,1
13224,1,0,0,0,0,0,0,1
13240,1,0,0,0,0,0,0,1
13242,1,0,0,0,0,0,0,1
13265,1,0,0,0,0,0,0,1
13280,2,0,0,0,0,0,0,2
13294,1,0,0,0,0,0,0,1
13320,1,0,0,0,0,0,0,1
13333,1,0,0,0,0,0,0,1
13343,1,0,0,0,0,0,0,1
13360,1,0,1,0,0,0,0,2
13370,0,0,0,0,1,0,0,1
13425,1,0,0,0,0,0,0,1
13440,6,1,0,0,0,0,0,7
13443,0,1,0,0,0,0,0,1
13480,1,0,0,0,0,0,0,1
13500,1,0,0,0,0,0,0,1
13520,1,0,0,0,0,0,0,1
13522,1,0,0,0,0,0,0,1
13531,1,0,0,0,0,0,0,1
13532,1,0,0,0,0,0,0,1
13552,1,0,0,0,0,0,0,1
13556,1,0,0,0,0,0,0,1
13560,3,0,1,0,0,0,0,4
13596,0,1,0,0,0,0,0,1
13600,3,0,0,0,0,0,0,3
13637,1,0,0,0,0,0,0,1
13638,0,0,0,1,0,0,0,1
13640,4,0,0,0,0,0,0,4
13680,1,0,0,0,0,0,0,1
13681,1,0,0,0,0,0,0,1
13698,1,0,0,0,0,0,0,1
13709,1,0,0,0,0,0,0,1
13720,1,0,0,0,0,0,0,1
13746,1,0,0,0,0,0,0,1
13760,3,1,0,0,0,0,0,4
13762,1,0,0,0,0,0,0,1
13792,1,0,0,0,0,0,0,1
13800,2,0,0,0,0,0,0,2
13840,4,0,0,0,0,0,0,4
13856,1,0,0,0,0,0,0,1
13874,1,0,0,0,0,0,0,1
13892,0,0,0,0,0,1,0,1
13913,1,0,0,0,0,0,0,1
13920,5,0,0,0,0,0,0,5
13926,1,0,0,0,0,0,0,1
13963,1,0,0,0,0,0,0,1
13969,1,0,0,0,0,0,0,1
14000,1,0,1,0,0,0,0,2
14040,3,0,1,0,0,0,0,4
14053,1,0,0,0,0,0,0,1
14076,1,0,0,0,0,0,0,1
14080,3,0,0,0,0,0,0,3
14099,1,0,0,0,0,0,0,1
14100,1,0,0,0,0,0,0,1
14118,1,0,0,0,0,0,0,1
14137,0,0,0,0,0,1,0,1
14140,1,0,0,0,0,0,0,1
14160,2,0,0,0,0,0,0,2
14200,1,0,0,0,0,0,0,1
14240,4,1,1,0,0,0,0,6
14280,2,0,1,0,0,0,0,3
14320,3,0,0,0,0,0,0,3
14350,1,0,0,0,0,0,0,1
14356,1,0,0,0,0,0,0,1
14400,8,0,0,0,0,0,0,8
14415,1,0,0,0,0,0,0,1
14440,1,0,0,0,0,0,0,1
14460,1,0,0,0,0,0,0,1
14477,1,0,0,0,0,0,0,1
14480,1,1,0,0,0,1,0,3
14515,1,0,0,0,0,0,0,1
14520,2,0,1,0,0,0,0,3
14535,1,0,0,0,0,0,0,1
14560,1,0,0,0,0,0,0,1
14571,1,0,0,0,0,0,0,1
14580,1,0,0,0,0,0,0,1
14591,0,0,0,0,0,1,0,1
14593,1,0,0,0,0,0,0,1
14594,1,0,0,0,0,0,0,1
14600,1,0,0,0,0,0,0,1
14640,4,0,0,0,0,0,0,4
14675,0,0,1,0,0,0,0,1
14720,4,0,0,0,0,0,0,4
14760,3,0,0,0,0,0,0,3
14765,1,0,0,0,0,0,0,1
14800,2,0,0,0,0,0,0,2
14828,1,0,0,0,0,0,0,1
14840,1,0,0,0,0,0,0,1
14879,1,0,0,0,0,0,0,1
14880,5,0,0,0,0,0,0,5
14896,1,0,0,0,0,0,0,1
14920,1,0,0,0,0,0,0,1
14940,1,0,0,0,0,0,0,1
14957,1,0,0,0,0,0,0,1
14960,3,0,0,0,0,0,0,3
14969,1,0,0,0,0,0,0,1
15000,3,0,0,0,0,0,0,3
15028,1,0,0,0,0,0,0,1
15030,1,0,0,0,0,0,0,1
15040,4,0,0,0,0,0,0,4
15055,1,0,0,0,0,0,0,1
15056,0,0,0,0,0,1,0,1
15080,1,0,0,0,0,0,0,1
15090,1,0,0,0,0,0,0,1
15120,4,0,0,0,0,0,0,4
15123,1,0,0,0,0,0,0,1
15132,0,0,0,1,0,0,0,1
15160,2,0,0,0,0,0,0,2
15200,4,0,1,0,0,0,0,5
15211,1,0,0,0,0,0,0,1
15240,0,0,1,0,0,0,0,1
15269,1,0,0,0,0,0,0,1
15280,5,1,1,0,0,0,0,7
15295,0,1,0,0,0,0,0,1
15304,1,0,0,0,0,0,0,1
15350,1,0,0,0,0,0,0,1
15360,4,0,0,0,0,0,0,4
15400,2,0,0,0,0,0,0,2
15425,1,0,0,0,0,0,0,1
15427,0,0,0,0,0,1,0,1
15438,1,0,0,0,0,0,0,1
15440,2,0,0,0,0,0,0,2
15455,1,0,0,0,0,0,0,1
15472,0,0,0,1,0,0,0,1
15480,4,0,0,0,0,0,0,4
15520,6,0,0,0,0,0,0,6
15533,1,0,0,0,0,0,0,1
15544,1,0,0,0,0,0,0,1
15560,1,0,0,0,0,0,0,1
15572,1,0,0,0,0,0,0,1
15578,1,0,0,0,0,0,0,1
15600,3,0,0,0,0,0,0,3
15605,1,0,0,0,0,0,0,1
15614,0,0,0,0,1,0,0,1
15615,1,0,0,0,0,0,0,1
15617,1,0,0,0,0,0,0,1
15639,1,0,0,0,0,0,0,1
15640,0,0,1,0,0,0,0,1
15659,1,0,0,0,0,0,0,1
15684,1,0,0,0,0,0,0,1
15713,1,0,0,0,0,0,0,1
15720,2,0,0,0,0,0,0,2
15750,0,0,1,0,0,0,0,1
15760,4,0,0,0,0,0,0,4
15795,1,0,0,0,0,0,0,1
15800,1,0,0,0,0,0,0,1
15814,1,0,0,0,0,0,0,1
15823,1,0,0,0,0,0,0,1
15840,2,0,1,0,0,0,0,3
15860,0,0,0,1,0,0,0,1
15920,2,1,0,0,0,0,0,3
15937,0,0,0,1,0,0,0,1
15960,1,0,0,0,0,0,0,1
16000,4,0,0,0,0,0,0,4
16003,1,0,0,0,0,0,0,1
16020,1,0,0,0,0,0,0,1
16032,0,0,1,0,0,0,0,1
16040,2,0,0,0,0,0,0,2
16080,3,0,0,0,0,0,0,3
16120,1,0,0,0,0,0,0,1
16145,1,0,0,0,0,0,0,1
16160,7,0,1,0,0,0,0,8
16200,2,0,0,0,0,0,0,2
16240,5,0,0,0,0,0,0,5
16280,0,0,1,0,0,0,0,1
16320,3,0,2,0,0,0,0,5
16343,1,0,0,0,0,0,0,1
16350,1,0,0,0,0,0,0,1
16360,0,1,0,0,0,0,0,1
16400,2,0,0,0,0,0,0,2
16403,1,0,0,0,0,0,0,1
16440,2,0,0,0,0,0,0,2
16452,1,0,0,0,0,0,0,1
16466,1,0,0,0,0,0,0,1
16472,1,0,0,0,0,0,0,1
16480,3,0,0,0,0,0,0,3
16500,1,0,0,0,0,0,0,1
16520,2,0,0,0,0,0,0,2
16560,3,0,1,0,0,0,0,4
16620,1,0,0,0,0,0,0,1
16640,2,0,0,0,0,0,0,2
16647,0,0,0,0,1,0,0,1
16680,2,0,0,0,0,0,0,2
16720,2,0,0,1,0,0,0,3
16722,1,0,0,0,0,0,0,1
16760,1,0,0,0,0,0,0,1
16800,1,0,0,0,0,0,0,1
16801,1,0,0,0,0,0,0,1
16832,1,0,0,0,0,0,0,1
16840,1,0,0,0,0,0,0,1
16841,0,0,1,0,0,0,0,1
16920,2,0,0,0,0,0,0,2
16926,0,0,0,1,0,0,0,1
16946,1,0,0,0,0,0,0,1
16952,1,0,0,0,0,0,0,1
16960,2,0,0,0,0,0,0,2
16993,1,0,0,0,0,0,0,1
17040,2,0,1,0,0,0,0,3
17080,0,1,0,0,0,0,0,1
17127,0,0,1,0,0,0,0,1
17153,0,0,0,1,0,0,0,1
17160,4,0,0,0,0,0,0,4
17183,1,0,0,0,0,0,0,1
17191,0,1,0,0,0,0,0,1
17200,1,0,1,0,0,0,0,2
17240,1,0,0,0,0,0,0,1
17255,0,0,0,0,1,0,0,1
17264,1,0,0,0,0,0,0,1
17275,0,1,0,0,0,0,0,1
17280,6,0,1,0,0,0,0,7
17320,1,0,0,0,0,0,0,1
17322,1,1,0,0,0,0,0,2
17360,1,0,1,0,0,0,0,2
17369,1,0,0,0,0,0,0,1
17400,3,0,0,0,0,0,0,3
17440,4,0,0,0,0,0,0,4
17480,0,0,0,0,0,1,0,1
17520,1,0,0,0,0,0,0,1
17560,1,0,0,0,0,0,0,1
17562,1,0,0,0,0,0,0,1
17565,0,0,0,1,0,0,0,1
17595,0,0,0,1,0,0,0,1
17600,5,0,0,0,0,0,0,5
17640,1,0,0,0,0,0,0,1
17707,0,0,0,1,0,0,0,1
17720,1,0,0,0,0,0,0,1
17760,2,0,0,0,0,0,0,2
17764,0,0,0,1,0,0,0,1
17773,2,0,0,0,0,0,0,2
17796,1,0,0,0,0,0,0,1
17817,1,0,0,0,0,0,0,1
17840,1,0,0,0,0,0,0,1
17850,1,0,0,0,0,0,0,1
17880,2,0,0,0,0,0,0,2
17920,1,0,1,0,0,0,0,2
17921,1,0,0,0,0,0,0,1
17967,1,0,0,0,0,0,0,1
18000,4,1,0,0,0,0,0,5
18039,1,0,0,0,0,0,0,1
18080,4,0,0,0,0,0,0,4
18120,2,0,0,0,0,0,0,2
18160,2,0,0,0,0,0,0,2
18200,2,0,0,0,0,0,0,2
18206,0,0,1,0,0,0,0,1
18227,0,0,1,0,0,0,0,1
18240,9,0,1,0,0,0,0,10
18260,1,0,0,0,0,0,0,1
18280,1,0,0,0,0,0,0,1
18320,2,0,1,0,0,0,0,3
18345,1,0,0,0,0,0,0,1
18360,1,0,0,0,0,0,0,1
18371,1,0,0,0,0,0,0,1
18376,1,0,0,0,0,0,0,1
18383,1,0,0,0,0,0,0,1
18400,3,0,0,0,0,0,0,3
18411,1,0,0,0,0,0,0,1
18430,1,0,0,0,0,0,0,1
18452,0,0,0,1,0,0,0,1
18480,4,0,0,0,0,0,0,4
18543,1,0,0,0,0,0,0,1
18550,1,0,0,0,0,0,0,1
18560,2,0,0,0,0,0,0,2
18579,0,0,1,0,0,0,0,1
18600,1,0,0,0,0,0,0,1
18640,3,0,0,0,0,0,0,3
18680,1,0,0,0,0,0,0,1
18720,3,0,0,0,0,0,0,3
18760,1,0,0,0,0,0,0,1
18800,3,0,0,0,0,0,0,3
18840,1,0,0,0,0,0,0,1
18880,1,0,0,1,0,0,0,2
18920,1,0,0,0,0,0,0,1
19000,2,1,0,0,0,0,0,3
19015,0,0,0,1,0,0,0,1
19040,1,1,0,0,0,0,0,2
19060,1,0,0,0,0,0,0,1
19080,2,0,0,0,0,0,0,2
19120,1,0,0,0,0,0,0,1
19134,0,0,0,1,0,0,0,1
19160,1,0,0,0,0,0,0,1
19180,0,0,0,1,0,0,0,1
19200,3,0,0,0,0,0,0,3
19250,1,0,0,0,0,0,0,1
19281,1,0,0,0,0,0,0,1
19293,1,0,0,0,0,0,0,1
19360,4,0,0,0,0,0,0,4
19389,1,0,0,0,0,0,0,1
19400,1,0,0,0,0,0,0,1
19406,1,0,0,0,0,0,0,1
19440,3,0,0,0,0,0,0,3
19520,2,0,0,0,0,0,0,2
19536,0,0,0,1,0,0,0,1
19560,2,0,0,0,0,0,0,2
19588,1,0,0,0,0,0,0,1
19600,3,0,0,0,0,0,0,3
19612,1,0,0,0,0,0,0,1
19641,1,0,0,0,0,0,0,1
19680,1,1,1,1,0,0,0,4
19695,1,0,0,0,0,0,0,1
19720,1,0,0,0,0,1,0,2
19726,1,0,0,0,0,0,0,1
19760,2,0,0,0,0,0,0,2
19800,1,1,0,0,0,0,0,2
19960,1,0,0,0,0,0,0,1
20000,3,0,0,0,0,0,0,3
20013,0,0,0,0,1,0,0,1
20040,2,0,0,0,0,0,0,2
20080,2,0,0,0,0,0,0,2
20100,1,0,0,0,0,0,0,1
20120,1,0,1,0,0,0,0,2
20160,3,0,0,0,0,0,0,3
20200,1,0,0,0,0,0,0,1
20220,1,0,0,0,0,0,0,1
20240,5,0,0,0,0,0,0,5
20249,1,0,0,0,0,0,0,1
20280,1,0,0,0,0,0,0,1
20281,1,0,0,0,0,0,0,1
20300,0,0,1,0,0,0,0,1
20320,1,0,1,0,0,0,0,2
20400,4,1,1,0,0,0,0,6
20410,1,0,0,0,0,0,0,1
20436,1,0,0,0,0,0,0,1
20440,1,0,0,0,0,0,0,1
20445,1,0,0,0,0,0,0,1
20485,0,0,1,0,0,0,0,1
20520,1,0,0,0,0,0,0,1
20560,1,0,0,0,0,0,0,1
20573,0,0,0,0,1,0,0,1
20600,2,0,0,0,0,0,0,2
20614,1,0,0,0,0,0,0,1
20640,1,0,0,0,0,0,0,1
20645,1,0,0,0,0,0,0,1
20720,1,0,0,0,0,0,0,1
20748,1,0,0,0,0,0,0,1
20760,1,0,0,0,0,0,0,1
20796,1,0,0,0,0,0,0,1
20800,5,0,0,0,0,0,0,5
20830,0,0,1,0,0,0,0,1
20880,1,0,0,0,0,0,0,1
20960,5,2,1,0,0,0,0,8
20964,1,0,0,0,0,0,0,1
21000,3,1,0,0,0,0,0,4
21040,1,1,0,0,0,0,0,2
21120,2,2,0,0,0,0,0,4
21170,1,0,0,0,0,0,0,1
21191,0,1,0,0,0,0,0,1
21200,3,0,0,0,0,0,0,3
21240,3,0,0,0,0,0,0,3
21300,1,0,0,0,0,0,0,1
21320,1,0,0,0,0,0,0,1
21351,1,0,0,0,0,0,0,1
21520,1,0,0,0,0,0,0,1
21600,1,0,0,0,0,0,0,1
21606,1,0,0,0,0,0,0,1
21637,0,1,0,0,0,0,0,1
21640,1,0,0,0,0,0,0,1
21678,1,0,0,0,0,0,0,1
21680,1,0,0,0,0,0,0,1
21704,0,0,1,0,0,0,0,1
21720,1,0,0,0,0,0,0,1
21760,1,0,0,0,0,0,0,1
21838,1,0,0,0,0,0,0,1
21840,1,0,0,0,0,0,0,1
21880,1,0,0,0,0,0,0,1
21899,1,0,0,0,0,0,0,1
21920,1,0,0,0,0,0,0,1
21953,1,0,0,0,0,0,0,1
21960,1,0,0,0,0,0,0,1
22000,1,0,0,0,0,0,0,1
22040,1,0,0,0,0,0,0,1
22043,0,0,0,1,0,0,0,1
22045,1,0,0,0,0,0,0,1
22080,2,0,1,0,0,0,0,3
22160,1,0,1,0,0,0,0,2
22211,0,0,0,0,1,0,0,1
22216,1,0,0,0,0,0,0,1
22240,2,0,0,0,0,0,0,2
22290,0,0,0,1,0,0,0,1
22317,0,0,1,0,0,0,0,1
22365,1,0,0,0,0,0,0,1
22400,1,0,0,0,0,0,0,1
22480,1,0,0,0,0,0,0,1
22536,0,0,0,1,0,0,0,1
22549,1,0,0,0,0,0,0,1
22558,0,1,0,0,0,0,0,1
22560,2,0,0,0,0,0,0,2
22640,2,0,0,0,0,0,0,2
22680,1,0,0,0,0,0,0,1
22720,3,0,0,0,0,0,0,3
22774,1,0,0,0,0,0,0,1
22779,1,0,0,0,0,0,0,1
22800,4,0,0,0,0,0,0,4
22880,2,0,0,0,0,0,0,2
22920,1,0,0,0,0,0,0,1
22973,0,1,0,0,0,0,0,1
23040,5,0,1,0,0,0,0,6
23120,4,0,0,0,0,0,0,4
23160,1,0,0,0,0,0,0,1
23200,2,0,0,0,0,0,0,2
23224,0,0,0,0,1,0,0,1
23280,4,0,0,0,0,0,0,4
23360,1,0,0,0,0,0,0,1
23400,1,0,0,0,0,0,0,1
23440,2,1,0,0,0,0,0,3
23480,1,0,0,0,0,0,0,1
23520,3,0,0,0,0,0,0,3
23600,3,0,0,0,0,0,0,3
23608,0,0,0,1,0,0,0,1
23640,2,0,0,0,0,0,0,2
23680,0,1,0,0,0,0,0,1
23717,1,0,0,0,0,0,0,1
23760,1,0,0,0,0,0,0,1
23840,3,0,0,0,0,0,0,3
23920,1,0,0,0,0,0,0,1
23936,1,0,0,0,0,0,0,1
23940,1,0,0,0,0,0,0,1
23981,1,0,0,0,0,0,0,1
24000,9,0,2,0,0,0,0,11
24080,1,0,0,0,0,0,0,1
24120,2,0,0,0,0,0,0,2
24160,0,0,1,0,0,0,0,1
24240,2,0,0,0,0,0,0,2
24320,0,1,0,0,0,0,0,1
24400,1,0,0,0,0,0,0,1
24444,1,0,0,0,0,0,0,1
24453,0,0,0,1,0,0,0,1
24480,2,0,0,0,0,0,0,2
24560,1,0,0,0,0,0,0,1
24640,1,0,0,0,0,0,0,1
24720,4,0,0,0,0,0,0,4
24760,1,0,0,0,0,0,0,1
24900,1,0,0,0,0,0,0,1
24936,0,1,0,0,0,0,0,1
24960,1,0,0,0,0,0,0,1
25017,0,0,0,1,0,0,0,1
25040,2,0,0,0,0,0,0,2
25080,1,0,0,0,0,0,0,1
25120,1,0,0,0,0,0,0,1
25160,1,0,0,0,0,0,0,1
25161,0,0,0,1,0,0,0,1
25200,2,0,0,0,0,0,0,2
25280,3,0,0,0,0,0,0,3
25332,1,0,0,0,0,0,0,1
25400,1,0,0,0,0,0,0,1
25440,1,1,0,0,0,0,0,2
25444,1,0,0,0,0,0,0,1
25520,0,0,1,0,0,0,0,1
25600,1,0,0,0,0,0,0,1
25680,1,0,0,0,0,0,0,1
25740,1,0,0,0,0,0,0,1
25760,1,0,0,0,0,0,0,1
25800,1,0,0,0,0,0,0,1
25840,1,0,0,0,0,0,0,1
25867,0,0,0,0,0,1,0,1
25872,0,0,0,0,1,0,0,1
25920,2,0,0,0,0,0,0,2
25960,1,0,0,0,0,0,0,1
26000,2,1,0,0,0,0,0,3
26026,0,0,1,0,0,0,0,1
26040,1,0,1,0,0,0,0,2
26100,1,0,0,0,0,0,0,1
26240,1,0,0,0,0,0,0,1
26307,1,0,0,0,0,0,0,1
26312,0,0,0,1,0,0,0,1
26320,0,0,1,0,0,0,0,1
26400,1,0,1,0,0,0,0,2
26480,1,0,0,0,0,0,0,1
26551,0,1,0,0,0,0,0,1
26560,1,0,0,0,0,0,0,1
26598,0,0,0,1,0,0,0,1
26600,0,0,1,0,0,0,0,1
26640,0,0,1,0,0,0,0,1
26720,1,0,0,0,0,0,0,1
26773,1,0,0,0,0,0,0,1
26800,1,0,0,0,0,0,0,1
26835,1,0,0,0,0,0,0,1
26845,1,0,0,0,0,0,0,1
26880,2,0,0,0,0,0,0,2
26960,1,0,0,0,0,0,0,1
27000,1,0,1,0,0,0,0,2
27037,1,0,0,0,0,0,0,1
27040,2,0,0,0,0,0,0,2
27063,0,0,0,1,0,0,0,1
27120,2,0,1,0,0,0,0,3
27160,1,0,0,0,0,0,0,1
27196,1,0,0,0,0,0,0,1
27200,3,0,0,0,0,0,0,3
27213,1,0,0,0,0,0,0,1
27240,1,0,0,0,0,0,0,1
27280,2,0,0,0,0,0,0,2
27360,2,0,0,0,0,0,0,2
27480,1,0,0,0,0,0,0,1
27520,1,0,0,0,0,0,0,1
27600,2,0,0,0,0,0,0,2
27650,1,0,0,0,0,0,0,1
27680,3,0,0,0,0,0,0,3
27720,1,0,0,0,0,0,0,1
27840,0,1,0,0,0,0,0,1
27960,1,0,0,0,0,0,0,1
28080,0,1,0,0,0,0,0,1
28160,2,0,0,0,0,0,0,2
28168,1,0,0,0,0,0,0,1
28228,0,0,0,1,0,0,0,1
28240,1,0,0,0,0,0,0,1
28320,3,0,0,0,0,0,0,3
28323,1,0,0,0,0,0,0,1
28382,0,0,0,1,0,0,0,1
28400,3,0,0,0,0,0,0,3
28440,0,0,1,0,0,0,0,1
28467,1,0,0,0,0,0,0,1
28480,0,1,0,0,0,0,0,1
28560,2,0,0,0,0,0,0,2
28600,1,0,0,0,0,0,0,1
28612,1,0,0,0,0,0,0,1
28640,5,0,0,0,0,0,0,5
28651,0,0,0,0,1,0,0,1
28720,2,0,0,0,0,0,0,2
28842,1,0,0,0,0,0,0,1
28875,3,0,0,0,0,0,0,3
28880,1,0,0,0,0,0,0,1
28920,2,1,0,0,0,0,0,3
28975,0,0,1,0,0,0,0,1
29000,1,0,0,0,0,0,0,1
29040,1,0,0,0,0,0,0,1
29120,1,0,0,0,0,0,0,1
29200,1,0,0,0,0,0,0,1
29280,3,0,0,0,0,0,0,3
29360,3,0,0,0,0,0,0,3
29400,2,0,0,0,0,0,0,2
29440,2,0,0,0,0,0,0,2
29508,0,0,0,1,0,0,0,1
29522,1,0,0,0,0,0,0,1
29560,1,0,0,0,0,0,0,1
29680,2,0,0,0,0,0,0,2
29700,1,0,0,0,0,0,0,1
29760,1,0,0,0,0,0,0,1
29774,1,0,0,0,0,0,0,1
29800,1,0,0,0,0,0,0,1
29920,1,0,0,0,0,0,0,1
29937,0,1,0,0,0,0,0,1
30000,3,0,0,0,0,0,0,3
30055,0,0,0,1,0,0,0,1
30080,2,0,0,0,0,0,0,2
30120,1,0,0,0,0,0,0,1
30157,1,0,0,0,0,0,0,1
30160,1,0,0,0,0,0,0,1
30181,0,0,0,1,0,0,0,1
30240,1,0,0,0,0,0,0,1
30311,0,0,0,1,0,0,0,1
30322,1,0,0,0,0,0,0,1
30360,0,0,1,0,0,0,0,1
30400,0,0,1,0,0,0,0,1
30491,0,1,0,0,0,0,0,1
30560,2,0,0,0,0,0,0,2
30600,1,0,0,0,0,0,0,1
30640,1,0,0,0,0,0,0,1
30785,0,0,0,1,0,0,0,1
30800,1,0,0,0,0,0,0,1
30840,1,0,0,0,0,0,0,1
30880,2,0,0,0,0,0,0,2
30960,2,0,0,0,0,0,0,2
31040,2,0,0,0,0,0,0,2
31080,0,1,0,0,0,0,0,1
31120,1,0,0,0,0,0,0,1
31160,0,0,1,0,0,0,0,1
31200,1,0,1,0,0,0,0,2
31240,1,0,0,0,0,0,0,1
31280,1,0,0,0,0,0,0,1
31360,2,0,0,0,0,0,0,2
31440,1,0,0,0,0,0,0,1
31680,1,0,0,0,0,0,0,1
31750,0,1,0,0,0,0,0,1
31760,2,0,0,0,0,0,0,2
31840,1,0,0,0,0,0,0,1
31920,3,0,0,0,0,0,0,3
32000,1,0,0,0,0,0,0,1
32002,0,1,0,0,0,0,0,1
32025,2,0,0,0,0,0,0,2
32080,1,0,0,0,0,0,0,1
32200,0,0,1,0,0,0,0,1
32320,1,0,0,0,0,0,0,1
32400,1,0,0,0,0,0,0,1
32480,1,0,0,0,0,0,0,1
32520,2,0,0,0,0,0,0,2
32544,1,0,0,0,0,0,0,1
32632,0,0,0,1,0,0,0,1
32640,1,0,0,0,0,0,0,1
32720,2,0,0,0,0,0,0,2
32760,1,0,0,0,0,0,0,1
32840,1,0,0,0,0,0,0,1
32880,4,0,0,0,0,0,0,4
32960,3,0,0,0,0,0,0,3
33009,0,1,0,0,0,0,0,1
33040,1,0,0,0,0,0,0,1
33120,4,0,0,0,0,0,0,4
33440,3,0,0,0,0,0,0,3
33480,2,0,0,0,0,0,0,2
33520,1,0,0,0,0,0,0,1
33600,2,0,0,0,0,0,0,2
33642,1,0,0,0,0,0,0,1
33699,1,0,0,0,0,0,0,1
33750,1,0,0,0,0,0,0,1
33840,1,0,0,0,0,0,0,1
33900,1,0,0,0,0,0,0,1
33920,2,0,0,0,0,0,0,2
33967,0,0,0,1,0,0,0,1
34000,1,0,0,0,0,0,0,1
34080,1,0,0,0,0,0,0,1
34160,1,0,0,0,0,0,0,1
34200,3,0,0,0,0,0,0,3
34240,1,0,0,0,0,0,0,1
34258,0,0,0,1,0,0,0,1
34400,1,0,0,0,0,0,0,1
34560,1,0,0,0,0,0,0,1
34617,0,0,0,1,0,0,0,1
34640,1,0,0,0,0,0,0,1
34650,0,1,0,0,0,0,0,1
34920,1,0,0,0,0,0,0,1
35034,0,0,0,0,1,0,0,1
35200,1,0,0,0,0,0,0,1
35258,1,0,0,0,0,0,0,1
35520,1,0,0,0,0,0,0,1
35600,2,0,0,0,0,0,0,2
35680,1,0,0,0,0,0,0,1
36000,1,0,0,0,0,0,0,1
36080,2,0,0,0,0,0,0,2
36360,0,1,0,0,0,0,0,1
36400,1,0,0,0,0,0,0,1
36427,0,0,0,1,0,0,0,1
36480,1,1,0,0,0,0,0,2
36560,1,0,0,0,0,0,0,1
36809,0,0,1,1,0,0,0,2
36840,1,0,0,0,0,0,0,1
36880,1,0,0,0,0,0,0,1
37000,1,0,0,0,0,0,0,1
37040,1,0,0,0,0,0,0,1
37080,1,0,0,0,0,0,0,1
37200,2,0,0,0,0,0,0,2
37280,2,0,0,0,0,0,0,2
37315,1,0,0,0,0,0,0,1
37320,1,0,0,0,0,0,0,1
37360,0,1,0,0,0,0,0,1
37440,2,0,0,0,0,0,0,2
37520,0,1,0,0,0,0,0,1
37560,1,0,0,0,0,0,0,1
37600,0,0,1,0,0,0,0,1
37720,1,0,0,0,0,0,0,1
37772,1,0,0,0,0,0,0,1
37800,1,0,0,0,0,0,0,1
37920,0,0,2,0,0,0,0,2
38000,1,0,0,0,0,0,0,1
38055,1,0,0,0,0,0,0,1
38160,1,0,0,0,0,0,0,1
38190,1,0,0,0,0,0,0,1
38240,1,0,0,0,0,0,0,1
38280,1,0,0,0,0,0,0,1
38360,0,0,1,0,0,0,0,1
38400,1,0,0,0,0,0,0,1
38520,1,0,0,0,0,0,0,1
38640,0,1,0,0,0,0,0,1
38655,0,0,0,1,0,0,0,1
38680,0,0,0,1,0,0,0,1
38759,0,0,0,1,0,0,0,1
38800,1,0,0,0,0,0,0,1
38880,1,0,0,0,0,0,0,1
39000,2,0,0,0,0,0,0,2
39040,2,0,0,0,0,0,0,2
39200,2,0,0,0,0,0,0,2
39240,1,0,0,0,0,0,0,1
39360,1,0,0,0,0,0,0,1
39480,1,0,0,0,0,0,0,1
39504,0,0,0,1,0,0,0,1
39520,1,0,0,0,0,0,0,1
39600,1,0,0,0,0,0,0,1
39840,1,0,0,0,0,0,0,1
39872,1,0,0,0,0,0,0,1
40000,1,0,0,0,0,0,0,1
40120,0,0,1,0,0,0,0,1
40160,2,0,0,0,0,0,0,2
40400,1,0,0,0,0,0,0,1
40440,2,0,0,0,0,0,0,2
40718,0,0,0,1,0,0,0,1
40800,1,0,1,0,0,0,0,2
40847,0,1,0,0,0,0,0,1
40897,0,0,0,1,0,0,0,1
41040,1,0,0,0,0,0,0,1
41120,1,0,0,0,0,0,0,1
41280,2,1,0,0,0,0,0,3
41520,1,0,0,0,0,0,0,1
41600,1,0,0,0,0,0,0,1
41640,1,0,0,0,0,0,0,1
41644,0,0,0,1,0,0,0,1
41680,0,0,1,0,0,0,0,1
41844,0,0,0,1,0,0,0,1
41916,0,0,0,1,0,0,0,1
41920,1,0,0,0,0,0,0,1
42000,1,0,1,0,0,0,0,2
42017,0,0,0,1,0,0,0,1
42135,0,0,0,1,0,0,0,1
42160,2,0,0,0,0,0,0,2
42408,0,0,0,1,0,0,0,1
42579,0,0,0,1,0,0,0,1
42600,0,1,0,0,0,0,0,1
42601,1,0,0,0,0,0,0,1
42606,0,0,0,1,0,0,0,1
42681,0,0,0,1,0,0,0,1
42720,1,0,0,0,0,0,0,1
42914,0,0,0,1,0,0,0,1
42920,1,0,0,0,0,0,0,1
43040,1,0,0,0,0,0,0,1
43080,1,0,0,0,0,0,0,1
43120,0,1,0,0,0,0,0,1
43320,1,0,0,0,0,0,0,1
43546,0,0,0,1,0,0,0,1
43575,1,0,0,0,0,0,0,1
43600,1,0,0,0,0,0,0,1
43640,1,0,0,0,0,0,0,1
43760,1,0,0,0,0,0,0,1
43844,0,0,0,1,0,0,0,1
43960,0,1,0,0,0,0,0,1
44040,1,0,0,0,0,0,0,1
44100,1,0,0,0,0,0,0,1
44200,1,0,0,0,0,0,0,1
44205,0,0,0,1,0,0,0,1
44304,0,0,0,1,0,0,0,1
44305,0,0,0,1,0,0,0,1
44400,1,0,0,0,0,0,0,1
44450,1,0,0,0,0,0,0,1
44600,1,0,0,0,0,0,0,1
44690,0,0,0,1,0,0,0,1
44720,1,0,0,0,0,0,0,1
44800,2,0,0,0,0,0,0,2
45082,1,0,0,0,0,0,0,1
45179,0,0,0,1,0,0,0,1
45200,2,0,0,0,0,0,0,2
45300,1,0,0,0,0,0,0,1
45450,1,0,0,0,0,0,0,1
45480,1,0,0,0,0,0,0,1
45520,1,0,0,0,0,0,0,1
45600,1,0,0,0,0,0,0,1
45695,0,0,0,1,0,0,0,1
45720,1,0,0,0,0,0,0,1
45960,1,0,0,0,0,0,0,1
46160,0,0,1,0,0,0,0,1
46200,1,0,0,0,0,0,0,1
46276,0,0,0,1,0,0,0,1
46471,0,0,0,1,0,0,0,1
46560,1,1,0,0,0,0,0,2
46880,1,0,0,0,0,0,0,1
46935,0,0,0,1,0,0,0,1
46972,0,0,0,1,0,0,0,1
47100,0,0,0,1,0,0,0,1
47200,1,0,0,0,0,0,0,1
47360,1,0,0,0,0,0,0,1
47520,1,0,0,0,0,0,0,1
47636,0,0,0,1,0,0,0,1
47640,1,0,0,0,0,0,0,1
47714,1,0,0,0,0,0,0,1
47880,1,0,0,0,0,0,0,1
47907,0,1,0,0,0,0,0,1
48040,1,0,0,0,0,0,0,1
48146,0,0,0,1,0,0,0,1
48320,1,0,0,0,0,0,0,1
48360,1,0,0,0,0,0,0,1
48450,1,0,0,0,0,0,0,1
48560,1,0,0,0,0,0,0,1
48720,1,0,0,0,0,0,0,1
48800,2,0,0,0,0,0,0,2
48823,0,0,0,1,0,0,0,1
48960,1,0,0,0,0,0,0,1
49350,1,0,0,0,0,0,0,1
49582,0,0,1,0,0,0,0,1
49680,1,0,0,0,0,0,0,1
50049,0,0,0,1,0,0,0,1
50080,1,0,0,0,0,0,0,1
50100,1,0,0,0,0,0,0,1
50252,0,0,0,1,0,0,0,1
50560,1,0,0,0,0,0,0,1
50600,1,0,0,0,0,0,0,1
50720,1,1,0,0,0,0,0,2
50760,0,1,0,0,0,0,0,1
51000,1,0,0,0,0,0,0,1
51120,1,0,0,0,0,0,0,1
51200,1,0,0,0,0,0,0,1
51240,1,0,0,0,0,0,0,1
51360,1,0,0,0,0,0,0,1
51480,1,0,0,0,0,0,0,1
51600,1,0,0,0,0,0,0,1
51628,1,0,0,0,0,0,0,1
51978,0,0,1,0,0,0,0,1
52020,1,0,0,0,0,0,0,1
52056,0,0,0,1,0,0,0,1
52150,1,0,0,0,0,0,0,1
52200,0,1,0,0,0,0,0,1
52279,0,0,0,1,0,0,0,1
52320,1,0,0,0,0,0,0,1
52679,0,0,0,1,0,0,0,1
52800,1,0,0,0,0,0,0,1
52802,1,0,0,0,0,0,0,1
52867,1,0,0,0,0,0,0,1
52960,0,1,0,0,0,0,0,1
53160,1,0,0,0,0,0,0,1
53280,1,0,0,0,0,0,0,1
53287,0,0,0,1,0,0,0,1
53520,1,0,0,0,0,0,0,1
53573,0,0,0,1,0,0,0,1
53600,1,1,0,0,0,0,0,2
53704,0,0,0,1,0,0,0,1
53726,1,0,0,0,0,0,0,1
53760,1,0,0,0,0,0,0,1
54120,1,0,0,0,0,0,0,1
54973,0,0,0,1,0,0,0,1
55560,0,0,1,0,0,0,0,1
55600,1,0,0,0,0,0,0,1
55740,0,0,0,1,0,0,0,1
55800,1,0,0,0,0,0,0,1
56280,1,0,0,0,0,0,0,1
56480,1,0,0,0,0,0,0,1
56560,0,0,1,0,0,0,0,1
56800,2,0,0,0,0,0,0,2
56840,0,1,0,0,0,0,0,1
56960,1,0,0,0,0,0,0,1
57000,0,0,1,0,0,0,0,1
57050,0,0,1,0,0,0,0,1
57120,1,0,0,0,0,0,0,1
57280,1,0,0,0,0,0,0,1
57282,0,0,0,1,0,0,0,1
57359,0,0,0,1,0,0,0,1
57480,1,0,0,0,0,0,0,1
57547,0,0,0,1,0,0,0,1
57600,2,0,0,0,0,0,0,2
57662,0,0,0,1,0,0,0,1
57760,1,0,0,0,0,0,0,1
57920,1,0,0,0,0,0,0,1
57998,1,0,0,0,0,0,0,1
58080,1,0,0,0,0,0,0,1
58134,0,0,0,1,0,0,0,1
58200,1,0,0,0,0,0,0,1
58360,0,1,0,0,0,0,0,1
58400,1,0,0,0,0,0,0,1
58800,1,0,0,0,0,0,0,1
58980,0,1,0,0,0,0,0,1
59040,1,0,0,0,0,0,0,1
59186,0,0,0,1,0,0,0,1
59280,1,0,0,0,0,0,0,1
59415,0,0,0,1,0,0,0,1
59700,1,0,0,0,0,0,0,1
60000,0,0,1,0,0,0,0,1
60271,0,0,0,1,0,0,0,1
60400,1,0,0,0,0,0,0,1
60660,1,0,0,0,0,0,0,1
60835,1,0,0,0,0,0,0,1
61320,1,0,0,0,0,0,0,1
61331,0,0,0,1,0,0,0,1
61847,0,0,0,1,0,0,0,1
61920,1,0,0,0,0,0,0,1
61987,0,0,0,1,0,0,0,1
62007,1,0,0,0,0,0,0,1
62009,0,0,0,1,0,0,0,1
62187,0,0,0,1,0,0,0,1
62400,0,1,0,0,0,0,0,1
62911,0,0,0,1,0,0,0,1
63120,1,0,0,0,0,0,0,1
63326,0,0,0,1,0,0,0,1
63874,0,0,0,1,0,0,0,1
64000,1,0,0,0,0,0,0,1
64320,0,0,1,0,0,0,0,1
64400,1,0,0,0,0,0,0,1
64488,0,0,0,1,0,0,0,1
64800,1,0,0,0,0,0,0,1
65006,0,0,0,1,0,0,0,1
65040,1,0,0,0,0,0,0,1
65120,1,0,0,0,0,0,0,1
65440,1,0,0,0,0,0,0,1
65520,1,0,0,0,0,0,0,1
65736,0,0,1,0,0,0,0,1
66107,0,0,0,1,0,0,0,1
66200,1,0,0,0,0,0,0,1
66720,1,0,0,0,0,0,0,1
66800,0,0,1,0,0,0,0,1
67200,1,0,0,0,0,0,0,1
67280,0,1,0,0,0,0,0,1
67403,0,0,0,1,0,0,0,1
67520,0,0,0,1,0,0,0,1
67720,1,0,0,0,0,0,0,1
67800,0,1,0,0,0,0,0,1
67840,1,0,0,0,0,0,0,1
67920,1,0,0,0,0,0,0,1
68000,1,0,0,0,0,0,0,1
68196,0,0,0,1,0,0,0,1
68280,1,0,0,0,0,0,0,1
68370,0,0,0,1,0,0,0,1
68457,1,0,0,0,0,0,0,1
68760,1,0,0,0,0,0,0,1
68804,1,0,0,0,0,0,0,1
68950,0,0,0,1,0,0,0,1
68971,1,0,0,0,0,0,0,1
69023,0,0,0,1,0,0,0,1
69200,1,0,0,0,0,0,0,1
69334,0,0,0,1,0,0,0,1
69387,0,0,0,1,0,0,0,1
69440,1,0,0,0,0,0,0,1
69610,0,0,0,1,0,0,0,1
69760,0,0,1,0,0,0,0,1
70080,1,0,0,0,0,0,0,1
70155,0,0,0,1,0,0,0,1
70200,1,0,0,0,0,0,0,1
70880,1,0,0,0,0,0,0,1
71113,1,0,0,0,0,0,0,1
71551,0,0,0,1,0,0,0,1
71600,0,1,0,0,0,0,0,1
72000,1,0,0,0,0,0,0,1
72109,1,0,0,0,0,0,0,1
72120,1,0,1,0,0,0,0,2
72300,1,0,0,0,0,0,0,1
72342,0,0,0,1,0,0,0,1
72418,0,0,0,1,0,0,0,1
72960,2,0,0,0,0,0,0,2
73080,1,0,0,0,0,0,0,1
73206,0,0,0,1,0,0,0,1
73296,0,0,0,1,0,0,0,1
73412,1,0,0,0,0,0,0,1
73640,0,1,0,0,0,0,0,1
73760,1,0,0,0,0,0,0,1
73920,1,0,1,0,0,0,0,2
74440,0,1,0,0,0,0,0,1
74470,0,0,0,1,0,0,0,1
74548,1,0,0,0,0,0,0,1
74550,0,0,1,0,0,0,0,1
74560,2,0,0,0,0,0,0,2
74585,0,0,0,1,0,0,0,1
74703,0,0,0,1,0,0,0,1
74880,1,0,0,0,0,0,0,1
75028,0,0,0,1,0,0,0,1
75120,1,0,0,0,0,0,0,1
75200,1,0,0,0,0,0,0,1
75259,1,0,0,0,0,0,0,1
75372,0,0,0,1,0,0,0,1
75580,0,0,0,0,1,0,0,1
75680,1,0,0,0,0,0,0,1
75951,0,0,0,1,0,0,0,1
75998,0,0,0,1,0,0,0,1
76243,1,0,0,0,0,0,0,1
76382,1,0,0,0,0,0,0,1
76803,0,0,0,1,0,0,0,1
76959,0,0,0,1,0,0,0,1
77160,1,0,0,0,0,0,0,1
77280,1,0,0,0,0,0,0,1
77480,0,1,0,0,0,0,0,1
77840,0,0,1,0,0,0,0,1
77920,1,0,0,0,0,0,0,1
78052,0,0,0,2,0,0,0,2
78240,1,0,0,0,0,0,0,1
78270,0,0,0,1,0,0,0,1
78324,0,0,0,0,1,0,0,1
78942,0,0,0,1,0,0,0,1
78960,1,0,0,0,0,0,0,1
79206,0,0,0,1,0,0,0,1
80160,1,0,0,0,0,0,0,1
80500,1,0,0,0,0,0,0,1
80800,1,0,0,0,0,0,0,1
80968,0,1,0,0,0,0,0,1
81031,1,0,0,0,0,0,0,1
81120,1,0,0,0,0,0,0,1
81360,1,0,0,0,0,0,0,1
81767,0,0,0,1,0,0,0,1
81920,1,0,0,0,0,0,0,1
82313,1,0,0,0,0,0,0,1
82800,2,0,0,0,0,0,0,2
83004,1,0,0,0,0,0,0,1
83160,1,0,0,0,0,0,0,1
83328,1,0,0,0,0,0,0,1
83605,0,0,0,1,0,0,0,1
83680,1,1,0,0,0,0,0,2
83908,0,0,0,1,0,0,0,1
84300,1,0,0,0,0,0,0,1
84684,0,0,0,1,0,0,0,1
84840,1,0,0,0,0,0,0,1
84960,1,0,0,0,0,0,0,1
85304,0,0,1,0,0,0,0,1
85920,2,0,0,0,0,0,0,2
86342,0,0,0,1,0,0,0,1
86455,0,0,0,1,0,0,0,1
87686,0,0,0,1,0,0,0,1
88303,0,0,0,1,0,0,0,1
88335,0,0,0,1,0,0,0,1
88400,1,0,0,0,0,0,0,1
89247,0,0,0,1,0,0,0,1
89680,0,1,0,0,0,0,0,1
90153,0,0,0,1,0,0,0,1
90247,1,0,0,0,0,0,0,1
90492,1,0,0,0,0,0,0,1
90515,0,0,0,0,1,0,0,1
90991,0,0,0,1,0,0,0,1
91350,1,0,0,0,0,0,0,1
91800,1,0,0,0,0,0,0,1
92640,1,0,0,0,0,0,0,1
93311,0,0,0,1,0,0,0,1
93840,1,0,0,0,0,0,0,1
93954,1,0,0,0,0,0,0,1
94960,0,1,0,0,0,0,0,1
95100,1,0,0,0,0,0,0,1
95400,0,0,1,0,0,0,0,1
95963,0,0,0,1,0,0,0,1
97040,0,1,0,0,0,0,0,1
97440,0,0,1,0,0,0,0,1
97760,0,1,0,0,0,0,0,1
98040,1,0,0,0,0,0,0,1
98720,1,0,0,0,0,0,0,1
98826,0,0,0,1,0,0,0,1
99006,0,0,0,1,0,0,0,1
99040,1,0,0,0,0,0,0,1
99094,1,0,0,0,0,0,0,1
99696,0,0,0,1,0,0,0,1
101500,1,0,0,0,0,0,0,1
101520,1,0,0,0,0,0,0,1
102080,1,0,0,0,0,0,0,1
102624,0,0,0,1,0,0,0,1
102754,0,0,0,1,0,0,0,1
105168,0,0,0,1,0,0,0,1
105600,1,0,0,0,0,0,0,1
105915,0,0,1,0,0,0,0,1
106200,1,0,0,0,0,0,0,1
106240,0,0,1,0,0,0,0,1
106640,0,1,0,0,0,0,0,1
106880,1,0,0,0,0,0,0,1
107127,0,0,0,1,0,0,0,1
107827,0,0,0,1,0,0,0,1
107880,0,1,0,0,0,0,0,1
108285,0,0,0,1,0,0,0,1
109691,0,0,0,1,0,0,0,1
110345,0,0,0,1,0,0,0,1
111176,0,0,1,0,0,0,0,1
113121,1,0,0,0,0,0,0,1
113280,1,0,0,0,0,0,0,1
113400,1,0,0,0,0,0,0,1
114579,0,0,0,1,0,0,0,1
114803,0,0,0,1,0,0,0,1
114956,0,0,0,1,0,0,0,1
115720,0,1,0,0,0,0,0,1
115800,1,0,0,0,0,0,0,1
116000,0,1,0,0,0,0,0,1
116190,0,0,0,1,0,0,0,1
116823,0,0,0,1,0,0,0,1
120053,0,0,0,1,0,0,0,1
121200,0,1,0,0,0,0,0,1
121253,0,0,0,1,0,0,0,1
121606,0,1,0,0,0,0,0,1
121625,0,0,1,0,0,0,0,1
122000,1,0,0,0,0,0,0,1
122441,0,0,0,1,0,0,0,1
122880,0,0,0,1,0,0,0,1
122999,0,0,0,1,0,0,0,1
123120,0,1,0,0,0,0,0,1
123263,0,0,0,1,0,0,0,1
123353,0,0,0,1,0,0,0,1
123514,0,0,0,1,0,0,0,1
124222,0,0,0,1,0,0,0,1
124320,1,0,0,0,0,0,0,1
125480,0,1,0,0,0,0,0,1
126074,0,0,0,1,0,0,0,1
126173,1,0,0,0,0,0,0,1
126360,0,0,1,0,0,0,0,1
127501,1,0,0,0,0,0,0,1
127695,1,0,0,0,0,0,0,1
128000,1,0,0,0,0,0,0,1
129030,0,0,0,1,0,0,0,1
129960,1,0,0,0,0,0,0,1
129975,0,0,0,1,0,0,0,1
130074,0,0,1,0,0,0,0,1
130375,1,0,0,0,0,0,0,1
130900,1,0,0,0,0,0,0,1
131290,0,0,0,1,0,0,0,1
132640,1,0,0,0,0,0,0,1
132840,1,0,0,0,0,0,0,1
132880,0,1,0,0,0,0,0,1
133203,0,0,0,1,0,0,0,1
134176,0,0,0,1,0,0,0,1
134311,1,0,0,0,0,0,0,1
135200,0,1,0,0,0,0,0,1
135624,0,0,0,1,0,0,0,1
136080,0,1,0,0,0,0,0,1
136593,0,0,0,1,0,0,0,1
137341,0,1,0,0,0,0,0,1
137574,0,0,0,1,0,0,0,1
139234,0,0,0,1,0,0,0,1
142743,0,0,0,1,0,0,0,1
142917,0,0,0,1,0,0,0,1
142920,1,0,0,0,0,0,0,1
143066,0,0,0,1,0,0,0,1
143123,0,0,0,1,0,0,0,1
144347,0,0,0,1,0,0,0,1
146160,1,0,0,0,0,0,0,1
147396,0,0,0,1,0,0,0,1
147840,1,0,0,0,0,0,0,1
148325,0,0,0,1,0,0,0,1
152818,0,0,0,1,0,0,0,1
153600,1,0,0,0,0,0,0,1
159533,1,0,0,0,0,0,0,1
161000,1,0,0,0,0,0,0,1
161030,0,0,0,1,0,0,0,1
161182,0,0,0,1,0,0,0,1
161700,1,0,0,0,0,0,0,1
161805,1,0,0,0,0,0,0,1
162743,1,0,0,0,0,0,0,1
162936,0,0,0,1,0,0,0,1
163411,0,1,0,0,0,0,0,1
163800,1,0,0,0,0,0,0,1
167439,0,0,0,1,0,0,0,1
168053,0,0,0,0,1,0,0,1
169168,1,0,0,0,0,0,0,1
169539,0,0,0,1,0,0,0,1
171719,0,0,0,1,0,0,0,1
172073,0,0,0,1,0,0,0,1
172800,1,0,0,0,0,0,0,1
173700,1,0,0,0,0,0,0,1
176926,1,0,0,0,0,0,0,1
177439,0,0,0,1,0,0,0,1
177781,0,0,0,1,0,0,0,1
177840,0,1,0,0,0,0,0,1
179178,0,0,0,1,0,0,0,1
179589,0,0,0,1,0,0,0,1
180245,0,0,0,1,0,0,0,1
181300,0,0,0,1,0,0,0,1
184654,0,0,0,1,0,0,0,1
191640,0,0,0,1,0,0,0,1
192507,0,0,0,1,0,0,0,1
196453,0,0,0,1,0,0,0,1
197611,0,0,0,1,0,0,0,1
197823,0,0,0,1,0,0,0,1
198640,0,0,0,1,0,0,0,1
200330,0,0,0,1,0,0,0,1
202720,1,0,0,0,0,0,0,1
207391,0,0,0,1,0,0,0,1
208809,0,0,0,1,0,0,0,1
212437,0,0,0,1,0,0,0,1
212833,1,0,0,0,0,0,0,1
218774,0,0,0,1,0,0,0,1
220703,0,0,0,1,0,0,0,1
221599,0,0,0,1,0,0,0,1
222088,0,0,0,1,0,0,0,1
223893,0,0,0,1,0,0,0,1
224065,0,0,0,1,0,0,0,1
224161,0,0,0,1,0,0,0,1
228644,0,0,0,1,0,0,0,1
230759,0,0,0,1,0,0,0,1
231105,0,0,0,1,0,0,0,1
234650,0,0,0,1,0,0,0,1
237681,0,0,0,1,0,0,0,1
238104,0,0,0,1,0,0,0,1
238740,0,0,0,1,0,0,0,1
239172,0,0,0,1,0,0,0,1
240440,0,1,0,0,0,0,0,1
251177,0,0,0,1,0,0,0,1
258011,0,0,0,1,0,0,0,1
258080,1,0,0,0,0,0,0,1
266752,0,0,0,1,0,0,0,1
267384,0,0,0,1,0,0,0,1
271427,0,0,0,1,0,0,0,1
271735,0,0,0,1,0,0,0,1
272332,1,0,0,0,0,0,0,1
272526,0,0,0,1,0,0,0,1
277919,0,0,0,0,1,0,0,1
285806,0,0,0,1,0,0,0,1
304248,0,0,0,1,0,0,0,1
306159,0,0,0,1,0,0,0,1
306690,0,0,0,1,0,0,0,1
308513,0,0,0,1,0,0,0,1
310298,0,1,0,0,0,0,0,1
317929,0,0,0,1,0,0,0,1
321605,0,0,0,1,0,0,0,1
339499,1,0,0,0,0,0,0,1
343872,0,0,0,1,0,0,0,1
347180,0,0,0,1,0,0,0,1
349029,0,0,0,1,0,0,0,1
349279,0,0,0,1,0,0,0,1
358826,0,0,0,1,0,0,0,1
369648,0,0,0,1,0,0,0,1
379280,0,0,0,1,0,0,0,1
397158,0,0,0,1,0,0,0,1
397557,0,0,0,1,0,0,0,1
404401,1,0,0,0,0,0,0,1
410348,0,0,0,1,0,0,0,1
414612,0,0,0,1,0,0,0,1
427003,0,0,0,1,0,0,0,1
429379,0,0,0,1,0,0,0,1
440171,0,0,0,1,0,0,0,1
442177,0,0,0,1,0,0,0,1
446073,0,0,0,1,0,0,0,1
448408,0,1,0,0,0,0,0,1
450777,0,0,0,1,0,0,0,1
464772,0,0,0,1,0,0,0,1
484880,0,0,0,1,0,0,0,1
506468,0,0,0,1,0,0,0,1
543163,0,0,0,1,0,0,0,1
564032,0,0,0,1,0,0,0,1
602696,0,0,0,1,0,0,0,1
644040,0,0,0,1,0,0,0,1
665193,0,0,0,1,0,0,0,1
688548,0,0,0,1,0,0,0,1
692584,0,0,0,1,0,0,0,1
853817,0,0,0,1,0,0,0,1
895509,0,1,0,0,0,0,0,1
924565,0,0,0,1,0,0,0,1
1048732,0,0,0,1,0,0,0,1
1179158,0,0,0,1,0,0,0,1
1181717,0,0,0,1,0,0,0,1
1377111,0,0,0,1,0,0,0,1
2541825,0,0,0,1,0,0,0,1
3673611,0,0,0,1,0,0,0,1