Consumo,TCO,TCS,TIN,TMT,TMTb,TRE,TUD,Total general
0,6451,383,238,3,0,20065,0,27140
1,1058,84,27,0,0,3299,0,4468
2,689,71,19,0,0,2023,0,2802
3,530,55,8,0,0,1620,0,2213
4,453,52,10,0,0,1439,0,1954
5,474,53,18,0,0,1290,0,1835
6,384,43,6,0,0,1150,0,1583
7,388,41,8,0,0,1096,0,1533
8,373,29,9,0,0,1042,0,1453
9,343,27,8,0,0,1051,0,1429
10,371,41,12,0,0,1110,0,1534
11,309,40,7,0,0,949,0,1305
12,287,36,12,0,0,927,0,1262
13,280,20,4,0,0,866,0,1170
14,272,27,8,0,0,919,0,1226
15,340,32,8,0,0,996,0,1376
16,242,28,9,0,0,832,0,1111
17,251,15,2,0,0,885,0,1153
18,266,25,7,0,0,884,0,1182
19,244,29,9,0,0,829,0,1111
20,261,26,2,0,0,923,0,1212
21,225,25,6,0,0,871,0,1127
22,237,22,10,0,0,843,0,1112
23,241,24,5,0,0,875,0,1145
24,226,20,8,0,0,817,0,1071
25,305,18,3,0,0,845,0,1171
26,228,15,3,0,0,919,0,1165
27,206,21,6,0,0,941,0,1174
28,226,30,4,0,0,945,0,1205
29,232,34,6,0,0,939,0,1211
30,327,35,10,0,0,1440,0,1812
31,210,16,12,0,0,947,0,1185
32,223,25,5,0,0,934,0,1187
33,234,13,3,0,0,1011,0,1261
34,236,16,7,0,0,1002,0,1261
35,236,29,4,0,0,1019,0,1288
36,191,21,3,0,0,1016,0,1231
37,229,21,3,0,0,1089,0,1342
38,254,25,4,0,0,1160,0,1443
39,217,18,7,0,0,1233,0,1475
40,232,22,3,0,0,1172,0,1429
41,211,22,6,0,0,1177,0,1416
42,204,22,4,0,0,1180,0,1410
43,296,23,4,0,0,1265,0,1588
44,213,19,7,0,0,1205,0,1444
45,233,27,2,0,0,1485,0,1747
46,215,18,5,0,0,1234,0,1472
47,199,20,7,0,0,1334,0,1560
48,182,27,4,0,0,1299,0,1512
49,214,28,6,0,0,1297,0,1545
50,258,22,8,0,0,1488,0,1776
51,218,19,9,0,0,1370,0,1616
52,177,24,8,0,0,1455,0,1664
53,186,28,5,0,0,1465,0,1684
54,194,26,2,0,0,1514,0,1736
55,205,15,8,0,0,1503,0,1731
56,184,18,8,0,0,1603,0,1813
57,220,22,3,0,0,1510,0,1755
58,213,9,8,0,0,1557,0,1787
59,199,18,5,0,0,1578,0,1800
60,326,31,9,0,0,2672,0,3038
61,205,14,5,0,0,1642,0,1866
62,185,13,6,0,0,1656,0,1860
63,200,19,4,0,0,1735,0,1958
64,162,16,9,0,0,1791,0,1978
65,171,27,5,0,0,1787,0,1990
66,188,17,7,0,0,1766,0,1978
67,191,22,7,0,0,1863,0,2083
68,205,22,5,0,0,1833,0,2065
69,171,18,4,0,0,2009,0,2202
70,176,19,11,0,0,1924,0,2130
71,187,22,6,0,0,1994,0,2209
72,188,15,7,0,0,1978,0,2188
73,179,17,9,0,0,2000,0,2205
74,155,13,2,0,0,1943,0,2113
75,233,21,3,0,0,2468,0,2725
76,165,15,5,0,0,2086,0,2271
77,180,19,5,0,0,2093,0,2297
78,176,15,5,0,0,2142,0,2338
79,195,14,7,0,0,2225,0,2441
80,200,13,1,0,0,2340,0,2554
81,178,22,8,0,0,2209,0,2417
82,192,17,6,0,0,2293,0,2508
83,166,13,8,0,0,2278,0,2465
84,188,9,5,0,0,2341,0,2543
85,180,25,8,0,0,2299,0,2512
86,182,14,1,0,0,2370,0,2567
87,181,13,7,0,0,2299,0,2500
88,194,10,5,0,0,2390,0,2599
89,183,11,5,0,0,2373,0,2572
90,258,18,9,0,0,3953,0,4238
91,197,16,4,0,0,2487,0,2704
92,177,12,9,0,0,2472,0,2670
93,173,17,6,0,0,2630,0,2826
94,179,18,3,0,0,2506,0,2706
95,166,23,5,0,0,2499,0,2693
96,148,13,2,0,0,2644,0,2807
97,154,15,4,0,0,2725,0,2898
98,175,18,3,0,0,2711,0,2907
99,163,13,3,0,0,2996,0,3175
100,199,18,4,0,0,2748,0,2969
101,128,20,3,0,0,2603,0,2754
102,156,10,5,0,0,2686,0,2857
103,147,9,2,0,0,2679,0,2837
104,172,9,1,0,0,2743,0,2925
105,183,18,8,0,0,3307,0,3516
106,161,16,0,0,0,2814,0,2991
107,161,9,4,0,0,2758,0,2932
108,156,16,2,0,0,2772,0,2946
109,158,15,0,0,0,2769,0,2942
110,171,17,3,0,0,3196,0,3387
111,160,12,5,0,0,2829,0,3006
112,164,13,4,0,0,3002,0,3183
113,135,23,1,0,0,2820,0,2979
114,157,10,2,0,0,2934,0,3103
115,174,14,3,0,0,2854,0,3045
116,154,14,7,0,0,2955,0,3130
117,160,13,5,0,0,2896,0,3074
118,158,15,3,0,0,2816,0,2992
119,133,17,4,0,0,2867,0,3021
120,209,21,3,0,0,4634,0,4867
121,151,7,4,0,0,2968,0,3130
122,146,11,7,0,0,2953,0,3117
123,125,13,1,0,0,2967,0,3106
124,131,10,9,0,0,3043,0,3193
125,162,11,4,0,0,2939,0,3116
126,161,13,4,0,0,2970,0,3148
127,147,9,3,0,0,3052,0,3211
128,155,10,7,0,0,2974,0,3146
129,149,11,2,0,0,3024,0,3186
130,174,16,6,0,0,3392,0,3588
131,155,18,6,0,0,2958,0,3137
132,147,10,2,0,0,3048,0,3207
133,147,10,1,0,0,2922,0,3080
134,120,11,2,0,0,3006,0,3139
135,145,6,6,0,0,3550,0,3707
136,135,10,2,0,0,3103,0,3250
137,131,16,2,0,0,2997,0,3146
138,138,11,6,0,0,3122,0,3277
139,127,8,2,0,0,2912,0,3049
140,144,10,4,0,0,3411,0,3569
141,135,15,2,0,0,2902,0,3054
142,141,19,2,0,0,3095,0,3257
143,146,9,2,0,0,2915,0,3072
144,111,12,3,0,0,3113,0,3239
145,132,12,3,0,0,2903,0,3050
146,109,14,3,0,0,2861,0,2987
147,117,11,4,0,0,3041,0,3173
148,113,14,3,0,0,2966,0,3096
149,139,10,5,0,0,2951,0,3105
150,192,13,9,0,0,4685,0,4899
151,112,20,6,0,0,2911,0,3049
152,136,7,7,0,0,2818,0,2968
153,126,14,5,0,0,2974,0,3119
154,125,6,4,0,0,2873,0,3008
155,148,12,5,0,0,2916,0,3081
156,115,4,1,0,0,3005,0,3125
157,126,13,1,0,0,3068,0,3208
158,125,9,1,0,0,2866,0,3001
159,114,5,4,0,0,2933,0,3056
160,122,10,4,0,0,3201,0,3337
161,117,5,5,0,0,2733,0,2860
162,116,6,4,0,0,2937,0,3063
163,107,9,4,0,0,2891,0,3011
164,145,7,4,0,0,2873,0,3029
165,141,5,1,0,0,3360,0,3507
166,114,7,3,0,0,2868,0,2992
167,105,9,5,0,0,2712,0,2831
168,127,10,3,0,0,2808,0,2948
169,122,10,1,0,0,2756,0,2889
170,121,8,3,0,0,3087,0,3219
171,115,8,4,0,0,2701,0,2828
172,102,10,6,0,0,2822,0,2940
173,101,8,2,0,0,2692,0,2803
174,116,11,3,0,0,2675,0,2805
175,118,7,3,0,0,2669,0,2797
176,119,3,3,0,0,2645,0,2770
177,104,12,4,0,0,2660,0,2780
178,128,9,1,0,0,2655,0,2793
179,81,8,1,0,0,2647,0,2737
180,179,19,2,0,0,4066,0,4266
181,111,10,3,0,0,2648,0,2772
182,104,11,0,0,0,2689,0,2804
183,98,8,4,0,0,2529,0,2639
184,113,14,7,0,0,2463,0,2597
185,107,6,2,0,0,2481,0,2596
186,90,5,4,0,0,2592,0,2691
187,86,4,4,0,0,2611,0,2705
188,107,9,2,0,0,2421,0,2539
189,101,10,2,0,0,2521,0,2634
190,98,16,1,0,0,2749,0,2864
191,108,6,4,0,0,2411,0,2529
192,93,6,4,0,0,2401,0,2504
193,98,10,2,0,0,2322,0,2432
194,98,5,3,0,0,2398,0,2504
195,111,13,5,0,0,2794,0,2923
196,110,8,8,0,0,2367,0,2493
197,102,8,1,0,0,2277,0,2388
198,102,8,4,0,0,2394,0,2508
199,98,11,3,0,0,2280,0,2392
200,106,7,4,0,0,2582,0,2699
201,95,11,3,0,0,2231,0,2340
202,106,7,2,0,0,2283,0,2398
203,91,9,3,0,0,2181,0,2284
204,107,11,3,0,0,2183,0,2304
205,95,8,3,0,0,2235,0,2341
206,88,8,1,0,0,2139,0,2236
207,89,11,2,0,0,2083,0,2185
208,100,6,1,0,0,2127,0,2234
209,101,6,1,0,0,2070,0,2178
210,143,11,5,0,0,3251,0,3410
211,108,8,0,0,0,2020,0,2136
212,92,4,2,0,0,1997,0,2095
213,77,6,3,0,0,2001,0,2087
214,88,9,4,0,0,1928,0,2029
215,101,9,3,0,0,2021,0,2134
216,98,6,0,0,0,1946,0,2050
217,91,8,7,0,0,1949,0,2055
218,97,9,3,0,0,1943,0,2052
219,99,2,3,0,0,1797,0,1901
220,88,10,1,0,0,2075,0,2174
221,83,3,3,0,0,1855,0,1944
222,88,6,0,0,0,1914,0,2008
223,103,1,3,0,0,1775,0,1882
224,72,5,1,0,0,1765,0,1843
225,114,9,4,0,0,2050,0,2177
226,74,8,5,0,0,1802,0,1889
227,82,5,2,0,0,1701,0,1790
228,72,6,2,0,0,1732,0,1812
229,84,6,2,0,0,1714,0,1806
230,98,9,3,0,0,1962,0,2072
231,84,13,1,0,0,1690,0,1788
232,103,13,2,0,0,1701,0,1819
233,93,5,1,0,0,1633,0,1732
234,93,5,1,0,0,1582,0,1681
235,76,8,1,0,0,1592,0,1677
236,106,9,1,0,0,1566,0,1682
237,73,3,3,0,0,1452,0,1531
238,81,4,1,0,0,1507,0,1593
239,66,7,4,0,0,1525,0,1602
240,120,10,7,0,0,2334,0,2471
241,67,4,0,0,0,1506,0,1577
242,75,9,1,0,0,1504,0,1589
243,76,7,1,0,0,1427,0,1511
244,78,3,3,0,0,1427,0,1511
245,85,7,2,0,0,1356,0,1450
246,84,5,2,0,0,1326,0,1417
247,75,6,5,0,0,1357,0,1443
248,89,5,5,0,0,1325,0,1424
249,94,4,3,0,0,1406,0,1507
250,97,5,1,0,0,1490,0,1593
251,83,7,0,0,0,1294,0,1384
252,73,2,3,0,0,1315,0,1393
253,81,5,1,0,0,1311,0,1398
254,71,8,2,0,0,1271,0,1352
255,92,5,2,0,0,1428,0,1527
256,82,6,3,0,0,1167,0,1258
257,69,4,3,0,0,1178,0,1254
258,75,6,1,0,0,1190,0,1272
259,68,8,4,0,0,1166,0,1246
260,73,6,3,0,0,1242,0,1324
261,75,6,0,0,0,1219,0,1300
262,78,2,4,0,0,1110,0,1194
263,70,7,0,0,0,1125,0,1202
264,62,4,2,0,0,1146,0,1214
265,74,8,4,0,0,1090,0,1176
266,79,3,2,0,0,1011,0,1095
267,71,9,2,0,0,1017,0,1099
268,74,7,6,0,0,965,0,1052
269,56,3,1,0,0,1025,0,1085
270,117,9,5,0,0,1643,0,1774
271,70,7,3,0,0,1017,0,1097
272,78,8,0,0,0,987,0,1073
273,65,3,1,0,0,992,0,1061
274,83,11,1,0,0,921,0,1016
275,62,2,0,0,0,963,0,1027
276,69,7,1,0,0,961,0,1038
277,64,5,4,0,0,974,0,1047
278,71,5,4,0,0,898,0,978
279,64,5,3,0,0,920,0,992
280,79,2,0,0,0,995,0,1076
281,85,7,1,0,0,832,0,925
282,73,4,0,0,0,902,0,979
283,65,3,0,0,0,844,0,912
284,62,6,1,0,0,834,0,903
285,81,5,2,0,0,1033,0,1121
286,68,9,2,0,0,823,0,902
287,77,4,1,0,0,791,0,873
288,69,4,1,0,0,875,0,949
289,72,0,5,0,0,802,0,879
290,63,8,2,0,0,900,0,973
291,62,7,5,0,0,747,0,821
292,74,8,0,0,0,757,0,839
293,58,4,3,0,0,800,0,865
294,95,4,1,0,0,718,0,818
295,63,5,2,0,0,743,0,813
296,66,10,1,0,0,764,0,841
297,46,7,3,0,0,716,0,772
298,62,6,1,0,0,676,0,745
299,59,7,2,0,0,749,0,817
300,87,9,1,0,0,1099,0,1196
301,56,0,0,0,0,678,0,734
302,64,6,3,0,0,658,0,731
303,52,7,1,0,0,672,0,732
304,76,2,3,0,0,682,0,763
305,67,6,2,0,0,651,0,726
306,71,4,3,0,0,638,0,716
307,71,3,1,0,0,619,0,694
308,77,4,3,0,0,627,0,711
309,50,9,4,0,0,646,0,709
310,68,6,3,0,0,686,0,763
311,57,2,4,0,0,595,0,658
312,60,3,4,0,0,627,0,694
313,56,11,0,0,0,591,0,658
314,60,4,2,0,0,579,0,645
315,56,5,1,0,0,675,0,737
316,44,2,2,0,0,549,0,597
317,63,2,2,0,0,564,0,631
318,58,4,4,0,0,548,0,614
319,59,4,3,0,0,582,0,648
320,60,8,4,0,0,574,0,646
321,67,3,4,0,0,513,0,587
322,40,6,0,0,0,567,0,613
323,54,4,1,0,0,507,0,566
324,51,5,2,0,0,545,0,603
325,65,8,3,0,0,518,0,594
326,62,4,0,0,0,479,0,545
327,65,6,3,0,0,531,0,605
328,50,2,2,0,0,507,0,561
329,62,4,0,0,0,525,0,591
330,89,1,3,0,0,719,0,812
331,63,6,2,0,0,460,0,531
332,66,6,4,0,0,445,0,521
333,45,2,4,0,0,429,0,480
334,53,7,3,0,0,467,0,530
335,65,4,1,0,0,450,0,520
336,68,4,1,0,0,445,0,518
337,61,3,4,0,0,443,0,511
338,59,4,3,0,0,443,0,509
339,57,5,3,0,0,412,0,477
340,69,4,4,0,0,479,0,556
341,44,4,0,0,0,416,0,464
342,54,1,1,0,0,403,0,459
343,58,1,0,0,0,417,0,476
344,52,3,1,0,0,403,0,459
345,61,5,1,0,0,470,0,537
346,62,4,4,0,0,415,0,485
347,48,2,2,0,0,405,0,457
348,50,6,2,0,0,384,0,442
349,55,1,1,0,0,353,0,410
350,57,3,2,0,0,421,0,483
351,65,6,2,0,0,380,0,453
352,62,4,0,0,0,356,0,422
353,61,3,2,0,0,352,0,418
354,58,3,3,0,0,335,0,399
355,54,4,2,0,0,331,0,391
356,48,5,2,0,0,364,0,419
357,50,6,4,0,0,298,0,358
358,55,4,1,0,0,316,0,376
359,71,4,3,0,0,358,0,436
360,107,6,4,0,0,539,0,656
361,45,3,1,0,0,319,0,368
362,59,4,2,0,0,318,0,383
363,58,4,1,0,0,305,0,368
364,47,5,0,0,0,296,0,348
365,50,7,3,0,0,312,0,372
366,61,5,1,0,0,300,0,367
367,64,8,5,0,0,350,0,427
368,61,4,3,0,0,316,0,384
369,54,2,1,0,0,285,0,342
370,56,5,4,0,0,330,0,395
371,41,6,3,0,0,303,0,353
372,57,7,1,0,0,274,0,339
373,49,4,1,0,0,288,0,342
374,46,4,1,0,0,298,0,349
375,72,5,1,0,0,337,0,415
376,46,7,0,0,0,255,0,308
377,43,9,3,0,0,268,0,323
378,59,4,2,0,0,269,0,334
379,55,3,1,0,0,244,0,303
380,70,3,1,0,0,301,0,375
381,62,6,0,0,0,236,0,304
382,46,6,2,0,0,261,0,315
383,63,3,1,0,0,252,0,319
384,42,4,2,0,0,281,0,329
385,57,3,1,0,0,248,0,309
386,41,5,1,0,0,239,0,286
387,51,2,1,0,0,241,0,295
388,48,7,1,0,0,238,0,294
389,56,2,2,0,0,238,0,298
390,79,7,1,0,0,383,0,470
391,51,4,2,0,0,229,0,286
392,51,0,1,0,0,248,0,300
393,58,2,2,0,0,210,0,272
394,55,5,0,0,0,229,0,289
395,42,3,0,0,0,210,0,255
396,58,5,0,0,0,224,0,287
397,55,6,3,0,0,231,0,295
398,46,4,2,0,0,218,0,270
399,59,3,1,0,0,188,0,251
400,61,2,4,0,0,229,0,296
401,44,1,3,0,0,180,0,228
402,49,6,1,0,0,191,0,247
403,54,5,3,0,0,232,0,294
404,54,3,2,0,0,191,0,250
405,52,5,2,0,0,243,0,302
406,50,4,1,0,0,203,0,258
407,48,1,1,0,0,175,0,225
408,52,4,1,1,0,206,0,264
409,45,6,1,0,0,202,0,254
410,44,6,3,0,0,194,0,247
411,44,5,0,0,0,191,0,240
412,39,2,2,0,0,183,0,226
413,40,1,2,0,0,193,0,236
414,39,6,0,0,0,189,0,234
415,48,1,2,0,0,207,0,258
416,40,4,0,0,0,200,0,244
417,44,2,5,0,0,166,0,217
418,41,4,0,0,0,164,0,209
419,53,8,2,0,0,181,0,244
420,59,5,3,0,0,239,0,306
421,51,6,1,0,0,176,0,234
422,40,4,4,0,0,158,0,206
423,56,6,3,0,0,166,0,231
424,29,1,1,0,0,159,0,190
425,46,4,2,0,0,151,0,203
426,47,6,1,0,0,174,0,228
427,52,3,3,0,0,160,0,218
428,54,0,3,0,0,143,0,200
429,49,2,0,0,0,149,0,200
430,61,3,2,0,0,178,0,244
431,43,4,1,0,0,159,0,207
432,49,4,1,0,0,144,0,198
433,39,2,0,0,0,139,0,180
434,46,3,1,0,0,161,0,211
435,61,6,1,0,0,199,0,267
436,44,2,3,0,0,151,0,200
437,35,3,0,0,0,161,0,199
438,42,2,0,0,0,149,0,193
439,49,4,1,0,0,133,0,187
440,30,3,1,0,0,158,0,192
441,47,6,0,0,0,134,0,187
442,52,2,0,0,0,142,0,196
443,37,5,1,0,0,148,0,191
444,47,2,1,0,0,138,0,188
445,41,5,1,0,0,137,0,184
446,45,7,3,0,0,126,0,181
447,47,4,2,0,0,127,0,180
448,38,6,1,0,0,117,0,162
449,38,0,2,0,0,141,0,181
450,54,5,2,0,0,202,0,263
451,39,0,4,0,0,128,0,171
452,38,2,1,0,0,126,0,167
453,53,5,0,0,0,139,0,197
454,52,3,1,0,0,117,0,173
455,35,1,1,0,0,130,0,167
456,31,0,4,0,0,136,0,171
457,47,4,4,0,0,132,0,187
458,33,1,1,0,0,114,0,149
459,49,5,2,0,0,164,0,220
460,55,0,3,0,0,156,0,214
461,45,5,1,0,0,106,0,157
462,51,3,3,0,0,118,0,175
463,36,1,3,0,0,112,0,152
464,49,3,2,0,0,115,0,169
465,58,7,3,0,0,136,0,204
466,47,3,1,0,0,113,0,164
467,41,3,1,0,0,102,0,147
468,43,4,2,0,0,119,0,168
469,34,4,1,0,0,115,0,154
470,46,1,3,0,0,133,0,183
471,44,3,0,0,0,104,0,151
472,40,1,1,0,0,110,0,152
473,29,6,0,0,0,108,0,143
474,31,1,1,0,0,113,0,146
475,32,2,1,0,0,92,0,127
476,50,3,1,0,0,104,0,158
477,45,4,0,0,0,107,0,156
478,36,3,3,0,0,88,0,130
479,46,1,2,0,0,106,0,155
480,65,8,2,0,0,182,0,257
481,48,1,0,0,0,89,0,138
482,41,2,0,0,0,104,0,147
483,39,3,1,0,0,99,0,142
484,36,5,1,0,0,93,0,135
485,36,2,0,0,0,109,0,147
486,34,4,2,0,0,102,0,142
487,45,3,0,0,0,107,0,155
488,45,1,2,0,0,88,0,136
489,38,1,1,0,0,102,0,142
490,46,2,5,0,0,109,0,162
491,34,3,1,0,0,83,0,121
492,39,2,0,0,0,77,0,118
493,42,2,1,0,0,80,0,125
494,23,2,3,0,0,90,0,118
495,57,6,4,0,0,117,0,184
496,39,3,1,0,0,87,0,130
497,38,2,3,0,0,100,0,143
498,36,1,1,0,0,83,0,121
499,41,2,0,0,0,79,0,122
500,41,3,1,0,0,94,0,139
501,28,0,1,0,0,79,0,108
502,36,2,1,0,0,84,0,123
503,37,4,1,0,0,78,0,120
504,40,3,1,0,0,83,0,127
505,40,4,3,0,0,90,0,137
506,40,2,2,0,0,80,0,124
507,31,2,3,0,0,77,0,113
508,32,2,1,0,0,97,0,132
509,28,1,1,0,0,89,0,119
510,51,4,1,0,0,128,0,184
511,36,1,2,0,0,82,0,121
512,30,1,0,0,0,100,0,131
513,31,2,0,0,0,72,0,105
514,39,1,2,0,0,79,0,121
515,36,6,0,0,0,71,0,113
516,40,4,2,0,0,65,0,111
517,40,0,0,0,0,77,0,117
518,37,4,0,0,0,73,0,114
519,27,0,0,0,0,87,0,114
520,33,3,1,0,0,90,0,127
521,39,3,1,0,0,87,0,130
522,41,8,3,0,0,75,0,127
523,40,2,3,0,0,71,0,116
524,31,4,0,0,0,65,0,100
525,43,3,1,0,0,94,0,141
526,29,2,4,0,0,73,0,108
527,42,2,1,0,0,94,0,139
528,27,2,2,0,0,66,0,97
529,31,1,3,0,0,71,0,106
530,41,4,1,0,0,71,0,117
531,43,1,0,0,0,66,0,110
532,38,4,1,0,0,64,0,107
533,34,3,1,0,0,62,0,100
534,38,0,1,0,0,70,0,109
535,30,0,0,0,0,64,0,94
536,29,2,0,0,0,80,0,111
537,24,4,2,0,0,63,0,93
538,39,1,1,0,0,69,0,110
539,42,0,2,0,0,64,0,108
540,56,5,2,0,0,98,0,161
541,34,5,1,0,0,76,0,116
542,25,0,2,0,0,60,0,87
543,43,2,0,0,0,55,0,100
544,28,2,0,0,0,61,0,91
545,35,2,3,0,0,50,0,90
546,38,1,0,0,0,63,0,102
547,23,2,1,0,0,65,0,91
548,40,2,0,0,0,75,0,117
549,37,2,2,0,0,46,0,87
550,42,3,0,0,0,57,0,102
551,42,1,2,0,0,48,0,93
552,32,2,2,0,0,64,0,100
553,25,4,1,0,0,55,0,85
554,25,4,2,0,0,56,0,87
555,40,0,3,0,0,73,0,116
556,37,1,0,0,0,68,0,106
557,25,1,1,0,0,72,0,99
558,31,1,0,0,0,53,0,85
559,29,0,2,0,0,62,0,93
560,30,3,0,0,0,56,0,89
561,31,1,1,0,0,49,0,82
562,35,4,1,0,0,48,0,88
563,36,1,0,0,0,55,0,92
564,29,4,0,0,0,41,0,74
565,21,3,1,0,0,49,0,74
566,35,1,2,0,0,42,0,80
567,27,2,3,0,0,52,0,84
568,27,2,0,0,0,58,0,87
569,33,2,1,0,0,59,0,95
570,42,0,2,0,0,85,0,129
571,35,2,5,0,0,50,0,92
572,38,2,3,0,0,52,0,95
573,23,1,3,0,0,49,0,76
574,28,0,1,0,0,37,0,66
575,29,6,0,0,0,47,0,82
576,28,2,2,0,0,44,0,76
577,29,4,1,0,0,42,0,76
578,28,4,0,0,0,46,0,78
579,36,5,1,0,0,46,0,88
580,33,3,2,0,0,59,0,97
581,50,2,3,0,0,45,0,100
582,32,3,1,0,0,50,0,86
583,27,2,1,0,0,36,0,66
584,21,1,3,0,0,48,0,73
585,32,1,0,0,0,62,0,95
586,42,0,1,0,0,46,0,89
587,28,2,0,0,0,49,0,79
588,31,4,0,0,0,44,0,79
589,25,0,2,0,0,55,0,82
590,35,3,0,0,0,47,0,85
591,26,4,0,0,0,61,0,91
592,36,2,2,0,0,43,0,83
593,25,6,0,0,0,43,0,74
594,28,2,1,0,0,30,0,61
595,38,1,1,0,0,50,0,90
596,19,1,0,0,0,40,0,60
597,24,1,1,0,0,41,0,67
598,29,1,0,0,0,44,0,74
599,22,4,2,0,0,42,0,70
600,47,7,0,0,0,78,0,132
601,26,2,1,0,0,51,0,80
602,27,1,1,0,0,50,0,79
603,27,4,1,0,0,46,0,78
604,31,1,3,0,0,46,0,81
605,30,4,2,0,0,46,0,82
606,38,1,2,0,0,48,0,89
607,30,0,0,0,0,45,0,75
608,26,2,2,0,0,40,0,70
609,24,0,0,0,0,47,0,71
610,21,1,0,0,0,58,0,80
611,26,1,3,0,0,50,0,80
612,33,1,3,0,0,41,0,78
613,31,0,2,0,0,43,0,76
614,32,2,1,0,0,34,0,69
615,36,1,3,0,0,44,0,84
616,33,0,1,0,0,41,0,75
617,33,0,0,0,0,29,0,62
618,24,1,1,0,0,54,0,80
619,21,2,1,0,0,33,0,57
620,25,3,1,0,0,43,0,72
621,29,2,0,0,0,42,0,73
622,27,1,0,0,0,41,0,69
623,24,4,2,0,0,54,0,84
624,26,0,1,0,0,38,0,65
625,23,1,2,0,0,33,0,59
626,32,4,1,0,0,29,0,66
627,41,3,0,0,0,39,0,83
628,28,0,0,0,0,36,0,64
629,35,4,2,0,0,35,0,76
630,48,1,3,0,0,51,0,103
631,23,1,1,0,0,42,0,67
632,32,3,1,0,0,37,0,73
633,20,2,3,0,0,29,0,54
634,24,3,2,0,0,30,0,59
635,33,0,1,0,0,36,0,70
636,24,2,3,0,0,43,0,72
637,26,4,0,0,0,43,0,73
638,25,5,0,0,0,32,0,62
639,36,2,1,0,0,42,0,81
640,31,1,0,0,0,29,0,61
641,23,3,1,0,0,32,0,59
642,17,4,3,0,0,25,0,49
643,29,3,0,0,0,33,0,65
644,27,3,3,0,0,33,0,66
645,33,3,0,0,0,49,0,85
646,25,2,2,0,0,40,0,69
647,24,2,1,0,0,29,0,56
648,21,0,1,0,0,39,0,61
649,27,2,1,0,0,40,0,70
650,27,1,0,0,0,49,0,77
651,30,0,2,0,0,29,0,61
652,24,1,2,0,0,38,0,65
653,25,1,2,0,0,29,0,57
654,26,3,0,0,0,30,0,59
655,32,0,0,0,0,30,0,62
656,28,3,2,0,0,42,0,75
657,27,1,1,0,0,34,0,63
658,27,1,2,0,0,30,0,60
659,23,2,0,0,0,18,0,43
660,46,2,1,0,0,54,0,103
661,19,7,0,0,0,27,0,53
662,20,1,1,0,0,33,0,55
663,23,0,0,0,0,36,0,59
664,20,3,0,0,0,23,0,46
665,29,1,1,0,0,29,0,60
666,27,4,0,0,0,31,0,62
667,35,4,1,0,0,39,0,79
668,30,2,0,0,0,25,0,57
669,37,1,1,0,0,35,0,74
670,25,2,1,0,0,40,0,68
671,27,2,0,0,0,21,0,50
672,26,3,0,0,0,35,0,64
673,31,4,1,0,0,33,0,69
674,28,1,3,0,0,22,0,54
675,32,1,3,0,0,27,0,63
676,32,1,1,0,0,24,0,58
677,18,0,0,0,0,25,0,43
678,28,3,0,0,0,18,0,49
679,30,3,3,0,0,26,0,62
680,29,3,2,0,0,25,0,59
681,23,2,0,0,0,27,0,52
682,30,0,1,0,0,17,0,48
683,25,2,2,0,0,33,0,62
684,28,2,0,0,0,20,0,50
685,29,1,1,0,0,28,0,59
686,32,3,1,0,0,20,0,56
687,35,0,0,0,0,28,0,63
688,34,1,0,0,0,28,0,63
689,24,1,1,0,0,25,0,51
690,36,1,1,0,0,46,0,84
691,18,4,2,0,0,32,0,56
692,25,2,0,0,0,22,0,49
693,23,2,3,0,0,28,0,56
694,22,3,1,0,0,22,0,48
695,28,0,0,0,0,26,0,54
696,31,2,1,0,0,19,0,53
697,22,4,1,0,0,24,0,51
698,18,1,1,0,0,27,0,47
699,20,0,1,0,0,25,0,46
700,25,1,2,0,0,23,0,51
701,25,1,0,0,0,24,0,50
702,25,1,1,0,0,39,0,66
703,17,1,2,0,0,27,0,47
704,28,1,0,0,0,33,0,62
705,30,0,2,0,0,35,0,67
706,28,3,1,0,0,31,0,63
707,18,1,0,0,0,29,0,48
708,26,1,1,0,0,28,0,56
709,28,0,1,0,0,25,0,54
710,26,2,3,0,0,16,0,47
711,26,4,1,0,0,14,0,45
712,25,3,1,0,0,21,0,50
713,19,3,0,0,0,25,0,47
714,21,3,2,0,0,23,0,49
715,23,3,2,0,0,24,0,52
716,27,3,1,0,0,27,0,58
717,19,1,2,0,0,28,0,50
718,20,0,0,0,0,30,0,50
719,15,0,0,0,0,23,0,38
720,39,1,2,0,0,57,0,99
721,18,0,1,0,0,23,0,42
722,22,1,0,0,0,24,0,47
723,19,0,3,0,0,33,0,55
724,29,5,0,0,0,22,0,56
725,23,1,1,0,0,20,0,45
726,21,1,0,0,0,22,0,44
727,22,0,1,0,0,18,0,41
728,38,2,1,0,0,22,0,63
729,29,0,0,0,0,27,0,56
730,25,0,1,0,0,31,0,57
731,21,2,1,0,0,19,0,43
732,24,0,0,0,0,24,0,48
733,17,2,1,0,0,25,0,45
734,22,1,2,0,0,17,0,42
735,34,0,2,0,0,22,0,58
736,21,1,1,0,0,23,0,46
737,18,2,0,0,0,17,0,37
738,23,2,1,0,0,28,0,54
739,16,1,2,0,0,19,0,38
740,30,0,0,0,0,27,0,57
741,20,0,1,0,0,24,0,45
742,21,2,1,0,0,22,0,46
743,15,0,0,0,0,15,0,30
744,36,1,0,0,0,23,0,60
745,24,0,1,0,0,21,0,46
746,23,1,1,0,0,22,0,47
747,13,0,0,0,0,16,0,29
748,18,0,0,0,0,17,0,35
749,19,2,2,0,0,20,0,43
750,44,3,2,0,0,41,0,90
751,27,2,1,0,0,25,0,55
752,17,1,0,0,0,26,0,44
753,22,3,2,0,0,19,0,46
754,10,1,0,0,0,26,0,37
755,22,2,1,0,0,20,0,45
756,24,2,0,0,0,20,0,46
757,26,1,1,0,0,24,0,52
758,26,0,0,0,0,16,0,42
759,25,3,0,0,0,26,0,54
760,19,0,1,0,0,20,0,40
761,10,1,0,0,0,9,0,20
762,21,1,2,0,0,20,0,44
763,15,1,0,0,0,26,0,42
764,28,1,2,0,0,20,0,51
765,26,2,0,0,0,27,0,55
766,21,1,1,0,0,24,0,47
767,23,0,2,0,0,21,0,46
768,22,1,2,0,0,18,0,43
769,19,3,1,0,0,18,0,41
770,24,0,1,0,0,22,0,47
771,23,3,0,0,0,18,0,44
772,15,1,0,0,0,23,0,39
773,15,0,1,0,0,22,0,38
774,19,0,0,0,0,22,0,41
775,25,0,0,0,0,28,0,53
776,17,3,0,0,0,18,0,38
777,22,4,0,0,0,19,0,45
778,22,1,1,0,0,18,0,42
779,13,2,1,0,0,9,0,25
780,44,2,0,0,0,31,0,77
781,20,4,3,0,0,22,0,49
782,11,1,0,0,0,15,0,27
783,12,2,1,0,0,26,0,41
784,33,0,3,0,0,11,0,47
785,25,0,3,0,0,27,0,55
786,19,0,2,0,0,14,0,35
787,19,1,0,0,0,19,0,39
788,16,0,0,0,0,18,0,34
789,23,3,0,0,0,13,0,39
790,23,0,0,0,0,18,0,41
791,15,2,2,0,0,15,0,34
792,30,1,1,0,0,23,0,55
793,12,0,0,0,0,15,0,27
794,22,2,2,0,0,16,0,42
795,28,0,0,0,0,16,0,44
796,21,1,0,0,0,19,0,41
797,17,1,0,0,0,15,0,33
798,26,1,0,0,0,13,0,40
799,19,1,0,0,0,10,0,30
800,25,3,1,0,0,12,0,41
801,22,1,0,0,0,16,0,39
802,21,0,0,0,0,13,0,34
803,13,2,0,0,0,12,0,27
804,22,2,0,0,0,17,0,41
805,20,2,0,0,0,26,0,48
806,17,0,0,0,0,14,0,31
807,14,2,2,0,0,21,0,39
808,15,2,0,0,0,19,0,36
809,22,2,1,0,0,21,0,46
810,26,3,0,0,0,32,0,61
811,17,1,1,0,0,11,0,30
812,13,1,2,0,0,16,0,32
813,19,0,0,0,0,12,0,31
814,20,1,0,0,0,14,0,35
815,25,0,0,0,0,12,0,37
816,24,2,1,0,0,9,0,36
817,20,0,0,0,0,22,0,42
818,22,1,1,0,0,19,0,43
819,22,0,0,0,0,13,0,35
820,23,0,0,0,0,15,0,38
821,21,2,1,0,0,25,0,49
822,28,0,1,0,0,21,0,50
823,8,0,2,0,0,19,0,29
824,18,2,0,0,0,15,0,35
825,24,1,2,0,0,20,0,47
826,20,0,0,0,0,7,0,27
827,18,3,0,0,0,12,0,33
828,28,1,1,0,0,13,0,43
829,20,0,1,0,0,11,0,32
830,19,1,1,0,0,19,0,40
831,22,0,1,0,0,18,0,41
832,20,3,0,0,0,19,0,42
833,16,2,2,0,0,16,0,36
834,19,3,0,0,0,10,0,32
835,21,2,0,0,0,12,0,35
836,15,1,0,0,0,13,0,29
837,22,2,0,0,0,22,0,46
838,27,2,0,0,0,21,0,50
839,18,1,0,0,0,16,0,35
840,30,3,5,0,0,21,0,59
841,17,2,0,0,0,9,0,28
842,14,0,0,0,0,15,0,29
843,16,0,0,0,0,15,0,31
844,20,2,0,0,0,14,0,36
845,16,1,1,0,0,11,0,29
846,21,1,0,0,0,13,0,35
847,19,0,0,0,0,9,0,28
848,15,2,0,0,0,10,0,27
849,18,0,3,0,0,19,0,40
850,22,0,1,0,0,16,0,39
851,20,2,0,0,0,10,0,32
852,21,1,3,0,0,9,0,34
853,23,0,1,0,0,15,0,39
854,28,3,0,0,0,8,0,39
855,20,0,0,0,0,21,0,41
856,19,0,1,0,0,16,0,36
857,25,1,3,1,0,12,0,42
858,24,2,3,0,0,6,0,35
859,14,2,0,0,0,19,0,35
860,12,0,1,0,0,11,0,24
861,24,0,0,0,0,13,0,37
862,20,2,1,0,0,11,0,34
863,18,3,1,0,0,20,0,42
864,21,0,2,0,0,15,0,38
865,22,1,2,0,0,8,0,33
866,19,0,1,0,0,15,0,35
867,15,1,1,0,0,11,0,28
868,14,0,3,0,0,12,0,29
869,21,1,0,0,0,10,0,32
870,25,3,1,0,0,13,0,42
871,21,0,0,0,0,10,0,31
872,19,1,1,0,0,9,0,30
873,16,1,0,0,0,9,0,26
874,16,3,2,0,0,13,0,34
875,18,2,0,0,0,13,0,33
876,15,1,2,0,0,19,0,37
877,18,1,0,0,0,14,0,33
878,12,0,1,0,0,8,0,21
879,18,1,0,0,0,15,0,34
880,18,2,0,0,0,11,0,31
881,17,3,0,0,0,14,0,34
882,22,3,1,0,0,12,0,38
883,16,1,2,0,0,11,0,30
884,16,2,1,0,0,20,0,39
885,24,1,2,0,0,20,0,47
886,18,0,1,0,0,7,0,26
887,18,0,1,0,0,16,0,35
888,19,0,0,0,0,12,0,31
889,14,0,0,0,0,15,0,29
890,23,1,0,0,0,18,0,42
891,21,2,1,0,0,16,0,40
892,12,1,2,0,0,20,0,35
893,14,0,1,0,0,8,0,23
894,19,1,0,0,0,10,0,30
895,12,0,0,0,0,9,0,21
896,14,1,1,0,0,6,0,22
897,16,2,1,0,0,14,0,33
898,13,2,1,0,0,9,0,25
899,17,0,1,0,0,19,0,37
900,32,1,0,0,0,22,0,55
901,10,1,1,0,0,11,0,23
902,18,1,1,0,0,9,0,29
903,10,1,0,0,0,13,0,24
904,16,4,1,0,0,4,0,25
905,20,0,0,0,0,16,0,36
906,13,1,0,0,0,20,0,34
907,20,0,0,0,0,8,0,28
908,15,1,0,0,0,5,0,21
909,19,2,1,0,0,14,0,36
910,21,2,1,0,0,9,0,33
911,24,1,0,0,0,10,0,35
912,23,1,0,0,0,12,0,36
913,23,0,0,0,0,10,0,33
914,22,1,0,0,0,9,0,32
915,21,1,0,0,0,11,0,33
916,20,1,0,0,0,10,0,31
917,27,1,2,0,0,8,0,38
918,15,1,3,0,0,9,0,28
919,19,4,0,0,0,11,0,34
920,26,1,0,0,0,15,0,42
921,15,1,0,0,0,13,0,29
922,18,0,0,0,0,9,0,27
923,18,1,0,0,0,13,0,32
924,14,0,0,0,0,9,0,23
925,17,0,1,0,0,9,0,27
926,20,1,0,0,0,14,0,35
927,14,2,2,0,0,9,0,27
928,11,1,0,0,0,11,0,23
929,20,1,0,0,0,9,0,30
930,16,2,2,0,0,20,0,40
931,16,2,1,0,0,11,0,30
932,20,0,1,0,0,6,0,27
933,19,1,1,0,0,10,0,31
934,21,1,3,0,0,11,0,36
935,13,1,0,0,0,12,0,26
936,20,0,1,0,0,9,0,30
937,19,2,0,0,0,11,0,32
938,19,1,0,0,0,11,0,31
939,26,0,1,0,0,16,0,43
940,19,1,0,0,0,15,0,35
941,12,0,0,0,0,12,0,24
942,14,0,0,0,0,12,0,26
943,20,1,1,0,0,12,0,34
944,12,0,1,0,0,8,0,21
945,22,1,0,0,0,12,0,35
946,14,1,0,0,0,10,0,25
947,13,2,0,0,0,9,0,24
948,9,1,0,0,0,15,0,25
949,13,0,0,0,0,4,0,17
950,12,0,1,0,0,8,0,21
951,19,1,1,0,0,10,0,31
952,25,1,0,0,0,6,0,32
953,10,1,0,0,0,10,0,21
954,14,3,2,0,0,9,0,28
955,17,1,0,0,0,10,1,29
956,19,1,2,0,0,8,0,30
957,13,2,0,0,0,6,0,21
958,25,0,0,0,0,5,0,30
959,16,0,1,0,0,15,0,32
960,35,0,0,0,0,17,0,52
961,19,0,0,0,0,11,0,30
962,13,1,0,0,0,7,0,21
963,13,0,0,0,0,17,0,30
964,11,1,1,0,0,11,0,24
965,15,1,0,0,0,10,0,26
966,21,0,1,0,0,8,0,30
967,14,1,1,0,0,4,0,20
968,13,0,1,0,0,12,0,26
969,11,2,2,0,0,9,0,24
970,18,0,1,0,0,5,0,24
971,9,0,0,0,0,6,0,15
972,11,0,0,0,0,10,0,21
973,17,1,2,0,0,12,0,32
974,8,2,2,0,0,5,0,17
975,12,2,0,0,0,14,0,28
976,13,0,1,0,0,12,0,26
977,13,0,1,0,0,8,0,22
978,13,1,2,0,0,11,0,27
979,17,1,6,0,0,8,0,32
980,15,0,1,0,0,9,0,25
981,15,1,1,0,0,10,0,27
982,18,0,0,0,0,17,0,35
983,9,0,2,0,0,9,0,20
984,17,2,0,0,0,6,0,25
985,15,1,1,0,0,13,0,30
986,11,0,0,0,0,10,0,21
987,10,0,0,0,0,3,0,13
988,25,2,1,0,0,9,0,37
989,12,2,1,0,0,11,0,26
990,24,1,0,0,0,10,0,35
991,13,1,0,0,0,11,0,25
992,11,2,0,0,0,11,0,24
993,16,0,0,0,0,12,0,28
994,17,2,0,0,0,10,0,29
995,11,0,2,0,0,8,0,21
996,7,2,0,0,0,12,0,21
997,15,0,0,0,0,8,0,23
998,8,0,1,0,0,14,0,23
999,17,0,1,0,0,3,0,21
1000,19,0,1,0,0,5,0,25
1001,19,1,0,0,0,7,0,27
1002,10,2,0,0,0,9,0,21
1003,6,0,0,0,0,5,0,11
1004,14,0,0,0,0,9,0,23
1005,14,2,2,0,0,4,0,22
1006,9,1,1,0,0,7,0,18
1007,13,1,0,0,0,4,0,18
1008,9,0,0,0,0,7,0,16
1009,8,1,0,0,0,5,0,14
1010,10,2,0,0,0,9,0,21
1011,17,0,0,0,0,6,0,23
1012,12,0,0,0,0,4,0,16
1013,14,5,0,0,0,7,0,26
1014,11,0,0,0,0,4,0,15
1015,13,2,1,0,0,11,0,27
1016,9,1,0,0,0,9,0,19
1017,11,1,1,0,0,2,0,15
1018,7,1,0,0,0,10,0,18
1019,19,0,2,0,0,3,0,24
1020,18,4,2,0,0,8,0,32
1021,12,0,1,0,0,13,0,26
1022,12,0,0,0,0,7,0,19
1023,12,0,0,0,0,8,0,20
1024,11,0,1,0,0,9,0,21
1025,15,2,0,0,0,6,0,23
1026,12,1,1,0,0,9,0,23
1027,12,0,0,0,0,7,0,19
1028,10,0,3,0,0,9,0,22
1029,9,0,0,0,0,10,0,19
1030,13,1,0,0,0,6,0,20
1031,12,0,1,0,0,8,0,21
1032,13,1,1,0,0,6,0,21
1033,15,1,0,0,0,9,0,25
1034,16,1,0,0,0,6,0,23
1035,17,0,1,0,0,8,0,26
1036,16,3,1,0,0,10,0,30
1037,14,0,0,0,0,5,0,19
1038,16,0,2,0,0,3,0,21
1039,15,1,0,0,0,4,0,20
1040,10,0,1,0,0,12,0,23
1041,13,1,1,0,0,11,0,26
1042,10,3,0,0,0,5,0,18
1043,13,1,1,0,0,9,0,24
1044,13,1,0,0,0,7,0,21
1045,7,0,0,0,0,12,0,19
1046,13,1,0,0,0,6,0,20
1047,10,0,1,0,0,9,0,20
1048,10,2,1,0,0,8,0,21
1049,6,2,1,0,0,6,0,15
1050,19,1,4,0,0,18,0,42
1051,9,1,0,0,0,9,0,19
1052,9,0,1,0,0,12,0,22
1053,12,1,0,0,0,11,0,24
1054,11,0,2,0,0,5,0,18
1055,9,0,2,0,0,6,0,17
1056,17,0,1,0,0,6,0,24
1057,12,0,2,0,0,7,0,21
1058,9,0,1,0,0,10,0,20
1059,12,0,0,0,0,10,0,22
1060,13,1,1,0,0,5,0,20
1061,12,0,1,0,0,9,0,22
1062,8,0,0,0,0,6,0,14
1063,10,1,1,0,0,10,0,22
1064,15,0,1,0,0,4,0,20
1065,7,1,0,0,0,4,0,12
1066,12,0,0,0,0,6,0,18
1067,23,2,0,0,0,11,0,36
1068,10,0,0,0,0,7,0,17
1069,16,0,0,0,0,6,0,22
1070,17,0,0,0,0,4,0,21
1071,9,1,0,0,0,4,0,14
1072,13,2,0,0,0,13,0,28
1073,13,1,0,0,0,8,0,22
1074,11,0,1,0,0,4,0,16
1075,11,0,0,0,0,8,0,19
1076,10,0,0,0,0,3,0,13
1077,13,1,1,0,0,4,0,19
1078,13,1,1,0,0,4,0,19
1079,14,0,1,0,0,8,0,23
1080,22,1,1,0,0,13,0,37
1081,9,1,1,0,0,7,0,18
1082,12,1,1,0,0,14,0,28
1083,13,0,0,0,0,9,0,22
1084,13,0,0,0,0,4,0,17
1085,19,0,1,0,0,6,0,26
1086,8,1,1,0,0,7,0,17
1087,11,0,1,0,0,4,0,16
1088,10,1,0,0,0,7,0,18
1089,12,0,1,0,0,3,0,16
1090,17,0,0,0,0,8,0,25
1091,16,1,1,0,0,11,0,29
1092,11,1,1,0,0,3,0,16
1093,17,2,1,0,0,8,0,28
1094,11,1,0,0,0,6,0,18
1095,15,0,1,0,0,5,0,21
1096,6,1,0,0,0,3,0,10
1097,10,0,0,0,0,6,0,16
1098,13,0,1,0,0,5,0,19
1099,16,2,0,0,0,8,0,26
1100,10,2,1,0,0,5,0,18
1101,15,0,0,0,0,7,0,22
1102,17,3,3,0,0,9,0,32
1103,14,2,1,0,0,7,0,24
1104,6,0,1,0,0,1,0,8
1105,13,1,1,0,0,5,0,20
1106,17,3,0,0,0,10,0,30
1107,14,0,0,0,0,4,0,18
1108,10,1,0,0,0,6,0,17
1109,6,1,0,0,0,10,0,17
1110,17,0,1,0,0,10,0,28
1111,5,0,0,0,0,7,0,12
1112,15,0,0,0,0,6,0,21
1113,9,0,0,0,0,3,0,12
1114,15,2,0,0,0,9,0,26
1115,9,0,0,0,0,9,0,18
1116,13,0,1,0,0,7,0,21
1117,13,2,0,0,0,3,0,18
1118,9,0,0,0,0,1,0,10
1119,8,0,4,0,0,4,0,16
1120,13,0,1,0,0,4,0,18
1121,9,2,1,0,0,4,0,16
1122,6,1,0,0,0,5,0,12
1123,9,0,0,0,0,5,0,14
1124,10,0,0,0,0,7,0,17
1125,19,1,0,0,0,8,0,28
1126,6,0,0,0,0,7,0,13
1127,17,1,1,0,0,5,0,24
1128,13,0,2,0,0,5,0,20
1129,18,0,0,0,0,6,0,24
1130,13,0,1,0,0,8,0,22
1131,17,1,1,0,0,4,0,23
1132,12,0,0,0,0,8,0,20
1133,9,0,0,0,0,5,0,14
1134,14,2,0,0,0,4,0,20
1135,13,0,0,0,0,9,0,22
1136,10,2,0,0,0,8,0,20
1137,17,0,0,0,0,8,0,25
1138,13,0,0,0,0,14,0,27
1139,15,0,0,0,0,10,0,25
1140,14,2,1,0,0,9,0,26
1141,16,0,0,0,0,5,0,21
1142,11,1,3,0,0,2,0,17
1143,9,1,2,0,0,6,0,18
1144,8,0,0,0,0,4,0,12
1145,14,1,0,0,0,6,0,21
1146,11,0,0,0,0,6,0,17
1147,15,1,2,0,0,5,0,23
1148,14,0,0,0,0,8,0,22
1149,8,0,1,0,0,4,0,13
1150,10,0,2,0,0,6,0,18
1151,10,0,0,0,0,6,0,16
1152,11,0,1,0,0,7,0,19
1153,16,0,0,0,0,6,0,22
1154,10,1,0,0,0,5,0,16
1155,10,2,1,0,0,6,0,19
1156,9,2,1,0,0,3,0,15
1157,12,0,2,0,0,5,0,19
1158,10,1,0,0,0,8,0,19
1159,13,1,0,0,0,8,0,22
1160,10,0,0,0,0,9,0,19
1161,16,0,1,0,0,4,0,21
1162,9,0,0,0,0,6,0,15
1163,16,1,0,0,0,4,0,21
1164,15,1,1,0,0,3,0,20
1165,10,1,0,0,0,7,0,18
1166,12,0,0,0,0,4,0,16
1167,9,0,0,0,0,2,0,11
1168,10,1,0,0,0,6,0,17
1169,18,1,1,0,0,4,0,24
1170,20,0,0,0,0,9,0,29
1171,7,0,0,0,0,5,0,12
1172,10,0,0,0,0,3,0,13
1173,6,1,0,0,0,5,0,12
1174,19,0,0,0,0,3,0,22
1175,15,0,1,0,0,4,0,20
1176,5,1,0,0,0,9,0,15
1177,7,2,0,0,0,5,0,14
1178,13,2,0,0,0,4,0,19
1179,10,3,1,0,0,7,0,21
1180,9,1,1,0,0,1,0,12
1181,9,2,0,0,0,6,0,17
1182,8,0,0,0,0,4,0,12
1183,10,2,0,0,0,5,0,17
1184,11,0,0,0,0,4,0,15
1185,13,0,1,0,0,7,0,21
1186,6,2,0,0,0,9,0,17
1187,8,0,0,0,0,5,0,13
1188,15,1,0,0,0,3,0,19
1189,4,1,0,0,0,3,0,8
1190,15,0,0,0,0,4,0,19
1191,8,1,1,0,0,8,0,18
1192,10,1,0,0,0,5,0,16
1193,6,0,1,0,0,6,0,13
1194,18,1,0,0,0,1,0,20
1195,12,0,0,0,0,8,0,20
1196,14,0,0,0,0,7,0,21
1197,12,0,1,0,0,6,0,19
1198,5,1,0,0,0,7,0,13
1199,10,0,0,0,0,2,0,12
1200,17,2,4,0,0,8,0,31
1201,7,0,0,0,0,2,0,9
1202,9,1,1,0,0,1,0,12
1203,10,4,0,0,0,11,0,25
1204,13,1,1,0,0,2,0,17
1205,4,1,1,0,0,5,0,11
1206,13,0,0,0,0,4,0,17
1207,11,1,0,0,0,6,0,18
1208,10,0,0,0,0,6,0,16
1209,10,0,0,0,0,4,0,14
1210,8,0,3,0,0,6,0,17
1211,13,0,0,0,0,6,0,19
1212,13,1,2,0,0,3,0,19
1213,11,0,0,0,0,4,0,15
1214,6,0,0,0,0,4,0,10
1215,21,0,1,0,0,10,0,32
1216,10,1,0,0,0,5,0,16
1217,11,2,0,0,0,6,0,19
1218,6,0,0,0,0,8,0,14
1219,8,0,0,0,0,7,0,15
1220,8,2,0,0,0,3,0,13
1221,9,3,0,0,0,4,0,16
1222,18,0,0,0,0,6,0,24
1223,15,0,0,0,0,3,0,18
1224,17,1,1,1,0,9,0,29
1225,16,0,0,0,0,5,0,21
1226,12,1,1,0,0,4,0,18
1227,17,2,0,0,0,4,0,23
1228,7,0,0,0,0,6,0,13
1229,10,0,2,0,0,7,0,19
1230,10,0,0,0,0,5,0,15
1231,15,1,2,0,0,2,0,20
1232,9,0,1,0,0,6,0,16
1233,14,0,1,0,0,4,0,19
1234,7,0,2,0,0,5,0,14
1235,16,2,1,0,0,3,0,22
1236,12,1,0,0,0,5,0,18
1237,10,2,0,0,0,1,0,13
1238,13,1,1,0,0,4,0,19
1239,9,1,1,0,0,4,0,15
1240,11,0,0,0,0,3,0,14
1241,13,1,1,0,0,6,0,21
1242,10,0,1,0,0,8,0,19
1243,11,0,2,0,0,8,0,21
1244,9,0,0,0,0,5,0,14
1245,13,0,0,0,0,5,0,18
1246,8,2,0,0,0,6,0,16
1247,11,2,0,0,0,2,0,15
1248,9,2,1,0,0,4,0,16
1249,9,0,1,0,0,2,0,12
1250,12,0,2,0,0,8,0,22
1251,7,0,1,0,0,6,0,14
1252,12,0,0,0,0,8,0,20
1253,9,1,0,0,0,7,0,17
1254,11,1,0,0,0,7,0,19
1255,7,1,2,0,0,5,0,15
1256,12,0,1,0,0,5,0,18
1257,6,1,0,0,0,4,0,11
1258,9,0,0,0,0,8,0,17
1259,11,2,0,0,0,4,0,17
1260,13,0,0,0,0,7,0,20
1261,13,0,0,0,0,2,0,15
1262,7,0,0,0,0,2,0,9
1263,18,0,1,0,0,3,0,22
1264,8,0,1,0,0,8,0,17
1265,11,2,2,0,0,4,0,19
1266,6,1,0,0,0,6,0,13
1267,13,1,1,0,0,2,0,17
1268,13,1,1,0,0,7,0,22
1269,7,0,1,0,0,5,0,13
1270,11,0,0,0,0,5,0,16
1271,9,1,1,0,0,5,0,16
1272,7,1,0,0,0,3,0,11
1273,12,1,0,0,0,7,0,20
1274,6,0,0,0,0,6,0,12
1275,8,2,0,0,0,2,0,12
1276,7,0,0,0,0,4,0,11
1277,12,0,0,0,0,3,0,15
1278,7,0,0,0,0,4,0,11
1279,10,0,0,0,0,3,0,13
1280,17,1,1,0,0,6,0,25
1281,11,1,0,0,0,3,0,15
1282,10,0,0,0,0,5,0,15
1283,7,1,0,0,0,0,0,8
1284,9,3,0,0,0,4,0,16
1285,10,0,0,0,0,5,0,15
1286,10,2,0,0,0,2,0,14
1287,11,0,0,0,0,7,0,18
1288,12,2,0,0,0,3,0,17
1289,13,2,1,0,0,0,0,16
1290,7,0,0,0,0,8,0,15
1291,4,0,0,0,0,2,0,6
1292,10,0,1,0,0,3,0,14
1293,9,0,0,0,0,4,0,13
1294,15,0,0,0,0,6,0,21
1295,7,1,0,0,0,4,0,12
1296,3,0,1,0,0,2,0,6
1297,12,0,0,0,0,8,0,20
1298,7,1,0,0,0,1,0,9
1299,10,1,1,0,0,4,0,16
1300,9,1,1,0,0,2,0,13
1301,11,1,0,0,0,5,0,17
1302,16,0,0,0,0,6,0,22
1303,9,0,0,0,0,0,0,9
1304,7,1,1,0,0,3,0,12
1305,18,1,0,0,0,6,0,25
1306,13,0,1,0,0,6,0,20
1307,10,0,1,0,0,1,0,12
1308,8,0,0,0,0,1,0,9
1309,11,1,0,0,0,2,0,14
1310,6,0,2,0,0,4,0,12
1311,10,0,0,0,0,6,0,16
1312,6,0,0,0,0,1,0,7
1313,12,0,0,0,0,4,0,16
1314,10,0,0,0,0,1,0,11
1315,12,1,2,0,0,6,0,21
1316,9,2,0,0,0,1,2,14
1317,13,0,1,0,0,4,0,18
1318,10,0,0,0,0,2,0,12
1319,12,0,2,0,0,2,0,16
1320,14,1,3,0,0,5,0,23
1321,15,0,0,0,0,1,0,16
1322,8,0,0,0,0,2,0,10
1323,7,0,1,0,0,0,0,8
1324,9,0,1,0,0,9,0,19
1325,13,0,0,0,0,3,0,16
1326,11,0,0,0,0,3,0,14
1327,16,0,1,0,0,1,0,18
1328,12,0,0,0,0,5,0,17
1329,6,1,0,0,0,3,0,10
1330,7,1,1,0,0,3,0,12
1331,4,0,1,0,0,1,0,6
1332,13,0,1,0,0,3,0,17
1333,11,1,0,0,0,2,0,14
1334,11,0,1,0,0,3,0,15
1335,11,0,1,0,0,3,0,15
1336,14,0,2,0,0,3,0,19
1337,12,1,1,0,0,1,0,15
1338,9,2,1,0,0,2,0,14
1339,7,0,2,0,0,3,0,12
1340,13,1,0,0,0,3,0,17
1341,10,0,0,0,0,5,0,15
1342,9,0,1,0,0,3,0,13
1343,13,0,2,0,0,8,0,23
1344,15,0,0,0,0,4,0,19
1345,10,0,0,0,0,3,0,13
1346,4,1,2,0,0,5,0,12
1347,10,1,0,0,0,2,0,13
1348,10,1,1,0,0,5,0,17
1349,6,0,1,0,0,3,0,10
1350,17,0,0,0,0,3,0,20
1351,15,0,0,0,0,2,0,17
1352,10,0,0,0,0,2,0,12
1353,12,0,0,0,0,3,0,15
1354,6,1,0,0,0,6,0,13
1355,11,1,0,0,0,2,0,14
1356,10,0,0,0,0,5,0,15
1357,10,0,0,0,0,4,0,14
1358,7,0,0,0,0,3,0,10
1359,10,0,0,0,0,3,0,13
1360,3,0,2,0,0,5,0,10
1361,11,0,0,0,0,3,0,14
1362,8,0,0,0,0,9,0,17
1363,11,0,0,0,0,4,0,15
1364,14,0,0,0,0,1,0,15
1365,10,2,1,0,0,3,0,16
1366,12,2,0,0,0,3,0,17
1367,10,0,1,0,0,3,0,14
1368,14,2,0,0,0,2,0,18
1369,8,0,1,0,0,2,0,11
1370,8,0,0,0,0,5,0,13
1371,13,1,0,0,0,1,0,15
1372,11,0,1,0,0,6,0,18
1373,9,0,0,0,0,0,0,9
1374,13,0,0,0,0,0,0,13
1375,13,1,1,0,0,3,0,18
1376,9,0,0,0,0,2,0,11
1377,9,0,2,0,0,1,0,12
1378,11,1,2,0,0,0,0,14
1379,9,0,1,0,0,5,0,15
1380,14,1,1,0,0,7,0,23
1381,8,1,0,0,0,1,0,10
1382,8,0,0,0,0,4,0,12
1383,8,0,0,0,0,5,0,13
1384,4,0,0,0,0,6,0,10
1385,5,0,2,0,0,3,0,10
1386,7,0,1,0,0,4,0,12
1387,12,0,1,0,0,1,0,14
1388,5,1,0,0,0,3,0,9
1389,13,0,0,0,0,1,0,14
1390,6,0,1,0,0,2,0,9
1391,7,1,0,0,0,3,0,11
1392,12,0,1,0,0,2,0,15
1393,11,1,1,0,0,1,0,14
1394,8,1,1,0,0,1,0,11
1395,13,1,1,0,0,3,0,18
1396,11,0,0,0,0,1,0,12
1397,11,0,1,0,0,5,0,17
1398,8,0,0,0,0,2,0,10
1399,5,0,1,0,0,2,0,8
1400,17,0,0,0,0,6,0,23
1401,12,0,0,0,0,1,0,13
1402,8,0,0,0,0,2,0,10
1403,5,0,0,0,0,5,0,10
1404,4,0,0,0,0,2,0,6
1405,8,0,0,0,0,4,0,12
1406,10,0,0,0,0,2,0,12
1407,10,0,0,0,0,3,0,13
1408,11,2,1,0,0,5,0,19
1409,8,1,0,0,0,3,0,12
1410,13,0,0,0,0,4,0,17
1411,3,0,1,0,0,2,0,6
1412,7,1,0,0,0,2,0,10
1413,3,1,0,0,0,2,0,6
1414,4,0,0,0,0,1,0,5
1415,6,0,0,0,0,2,0,8
1416,12,0,0,0,0,2,0,14
1417,6,0,1,0,0,2,0,9
1418,9,2,1,0,0,2,0,14
1419,6,0,1,0,0,2,0,9
1420,13,1,2,0,0,3,0,19
1421,7,0,0,0,0,2,0,9
1422,11,0,1,0,0,1,0,13
1423,8,1,0,0,0,3,0,12
1424,7,0,0,0,0,6,0,13
1425,13,1,0,0,0,3,0,17
1426,10,0,0,0,0,3,0,13
1427,9,0,0,0,0,3,0,12
1428,11,0,1,0,0,6,0,18
1429,9,0,0,0,0,2,0,11
1430,7,0,1,0,0,5,0,13
1431,13,0,0,0,0,3,0,16
1432,10,1,1,0,0,3,0,15
1433,7,0,0,0,0,1,0,8
1434,6,1,1,0,0,1,0,9
1435,15,1,1,0,0,3,0,20
1436,15,1,1,0,0,2,0,19
1437,12,0,1,0,0,4,0,17
1438,5,2,0,0,0,6,0,13
1439,6,0,0,0,0,3,0,9
1440,15,2,0,0,0,5,0,22
1441,8,2,1,0,0,0,0,11
1442,8,0,0,0,0,2,0,10
1443,3,0,0,0,0,6,0,9
1444,7,0,0,0,0,0,0,7
1445,5,0,1,0,0,3,0,9
1446,8,0,0,0,0,4,0,12
1447,7,0,0,0,0,1,0,8
1448,6,1,0,0,0,2,0,9
1449,8,0,0,0,0,3,0,11
1450,12,1,1,0,0,2,0,16
1451,10,0,0,0,0,2,0,12
1452,7,0,0,0,0,2,0,9
1453,9,0,0,0,0,3,0,12
1454,2,1,0,0,0,4,0,7
1455,6,1,0,0,0,1,0,8
1456,9,0,0,0,0,6,0,15
1457,7,0,1,0,0,1,0,9
1458,7,2,1,0,0,6,0,16
1459,7,1,0,0,0,1,0,9
1460,10,1,1,0,0,2,0,14
1461,7,1,1,0,0,1,0,10
1462,10,1,0,0,0,5,0,16
1463,8,0,1,0,0,5,0,14
1464,5,0,2,0,0,0,0,7
1465,8,0,0,0,0,3,0,11
1466,12,0,0,0,0,3,0,15
1467,8,0,0,0,0,3,0,11
1468,9,2,1,0,0,7,0,19
1469,15,3,0,1,0,2,0,21
1470,17,0,1,0,0,6,0,24
1471,10,1,0,0,0,0,0,11
1472,9,1,0,0,0,2,0,12
1473,8,1,1,0,0,0,0,10
1474,3,0,0,0,0,1,0,4
1475,10,0,1,0,0,4,0,15
1476,3,0,0,0,0,2,0,5
1477,8,0,0,0,0,1,0,9
1478,7,1,0,0,0,3,0,11
1479,5,1,0,0,0,5,0,11
1480,11,0,0,0,0,6,0,17
1481,8,1,1,0,0,1,0,11
1482,13,0,1,0,0,3,0,17
1483,6,1,0,0,0,3,0,10
1484,9,0,0,0,0,3,0,12
1485,9,1,0,0,0,3,0,13
1486,7,0,0,0,0,2,0,9
1487,4,1,1,0,0,4,0,10
1488,10,2,2,0,0,1,0,15
1489,4,0,1,0,0,1,0,6
1490,11,0,0,0,0,2,0,13
1491,7,0,0,0,0,1,0,8
1492,11,0,2,0,0,2,0,15
1493,7,0,2,0,0,3,0,12
1494,13,0,0,0,0,1,0,14
1495,10,0,1,0,0,7,0,18
1496,9,1,0,0,0,2,0,12
1497,5,0,0,0,0,1,0,6
1498,8,0,1,0,0,4,0,13
1499,4,0,0,0,0,2,0,6
1500,13,0,2,0,0,5,0,20
1501,9,0,0,0,0,3,0,12
1502,10,0,0,0,0,1,0,11
1503,10,0,2,0,0,3,0,15
1504,4,0,0,0,0,3,0,7
1505,1,0,1,0,0,4,0,6
1506,4,0,0,0,0,2,0,6
1507,8,1,2,0,0,2,0,13
1508,8,1,1,0,0,4,0,14
1509,9,1,0,0,0,4,0,14
1510,14,0,1,0,0,0,0,15
1511,5,0,0,0,0,3,0,8
1512,6,0,0,0,0,1,0,7
1513,7,0,0,0,0,0,0,7
1514,6,0,0,0,0,1,0,7
1515,3,0,0,0,0,2,0,5
1516,5,0,0,0,0,0,0,5
1517,3,1,0,0,0,1,0,5
1518,5,0,0,0,0,2,0,7
1519,8,0,1,0,0,1,0,10
1520,8,1,0,0,0,2,0,11
1521,10,0,0,0,0,3,0,13
1522,4,1,1,0,0,3,0,9
1523,6,0,0,0,0,2,0,8
1524,5,0,0,0,0,2,0,7
1525,5,1,0,0,0,0,0,6
1526,6,0,0,0,0,0,0,6
1527,3,1,0,0,0,4,0,8
1528,10,1,0,0,0,2,0,13
1529,5,0,1,0,0,3,0,9
1530,12,0,0,0,0,4,0,16
1531,9,0,1,0,0,1,0,11
1532,8,1,0,0,0,1,0,10
1533,7,0,1,0,0,1,0,9
1534,7,0,0,0,0,0,0,7
1535,10,1,0,0,0,3,0,14
1536,5,1,0,0,0,0,0,6
1537,10,1,0,0,0,4,0,15
1538,4,1,0,0,0,1,0,6
1539,7,0,0,0,0,1,0,8
1540,5,0,0,0,0,2,0,7
1541,7,0,0,0,0,3,0,10
1542,6,1,0,0,0,3,0,10
1543,7,1,2,0,0,0,0,10
1544,6,0,0,0,0,1,0,7
1545,5,0,0,0,0,2,0,7
1546,8,0,0,0,0,4,0,12
1547,4,0,0,0,0,3,0,7
1548,6,2,0,0,0,1,0,9
1549,5,0,0,0,0,1,0,6
1550,9,0,3,0,0,0,0,12
1551,11,0,0,0,0,1,0,12
1552,6,0,0,0,0,3,0,9
1553,2,0,1,0,0,2,0,5
1554,4,1,2,0,0,1,0,8
1555,10,1,0,0,0,1,0,12
1556,4,0,0,0,0,7,0,11
1557,3,0,1,0,0,2,0,6
1558,7,0,0,0,0,2,0,9
1559,9,1,0,0,0,0,0,10
1560,10,1,1,0,0,1,0,13
1561,8,0,0,0,0,1,0,9
1562,6,0,0,0,0,4,0,10
1563,2,0,1,0,0,2,0,5
1564,7,0,0,0,0,3,0,10
1565,8,2,0,0,0,4,0,14
1566,8,0,0,0,0,2,0,10
1567,14,0,0,0,0,1,0,15
1568,4,1,0,0,0,1,0,6
1569,9,0,0,0,0,0,0,9
1570,9,0,0,0,0,3,0,12
1571,6,2,0,0,0,1,0,9
1572,7,1,1,0,0,1,0,10
1573,7,0,0,0,0,0,0,7
1574,4,0,0,0,0,1,0,5
1575,5,0,0,0,0,3,0,8
1576,7,0,0,0,0,0,0,7
1577,3,0,0,0,0,1,0,4
1578,6,0,0,0,0,4,0,10
1579,7,0,1,0,0,4,0,12
1580,8,0,1,0,0,3,0,12
1581,8,0,2,0,0,1,0,11
1582,11,0,2,0,0,1,0,14
1583,7,0,0,0,0,2,0,9
1584,5,0,0,0,0,2,0,7
1585,6,0,1,0,0,0,0,7
1586,5,2,0,0,0,1,0,8
1587,4,1,0,0,0,3,0,8
1588,8,0,0,0,0,5,0,13
1589,8,0,0,0,0,3,0,11
1590,8,2,0,0,0,3,0,13
1591,12,2,1,0,0,1,0,16
1592,2,0,0,0,0,2,0,4
1593,5,0,0,0,0,1,0,6
1594,9,0,0,0,0,2,0,11
1595,9,0,2,0,0,3,0,14
1596,9,0,0,0,0,0,0,9
1597,5,0,0,0,0,4,0,9
1598,3,1,0,0,0,1,0,5
1599,5,1,0,0,0,2,0,8
1600,12,1,0,0,0,1,0,14
1601,12,1,0,0,0,1,0,14
1602,10,0,0,0,0,1,0,11
1603,7,0,1,0,0,3,0,11
1604,6,0,1,0,0,4,0,11
1605,11,0,2,0,0,5,0,18
1606,10,0,0,0,0,2,0,12
1607,5,2,0,0,0,2,0,9
1608,11,0,1,0,0,4,0,16
1609,6,0,0,0,0,1,0,7
1610,5,1,0,0,0,4,0,10
1611,9,0,0,0,0,1,0,10
1612,4,0,0,0,0,1,0,5
1613,5,0,0,0,0,3,0,8
1614,4,0,0,0,0,2,0,6
1615,8,0,0,0,0,3,0,11
1616,4,0,0,0,0,0,0,4
1617,7,0,0,0,0,1,0,8
1618,14,0,0,0,0,1,0,15
1619,9,0,0,0,0,0,0,9
1620,10,0,0,0,0,4,0,14
1621,3,0,1,0,0,0,0,4
1622,10,0,0,0,0,3,0,13
1623,4,0,1,0,0,4,0,9
1624,8,0,0,0,0,1,0,9
1625,8,0,0,0,0,1,0,9
1626,6,0,0,0,0,1,0,7
1627,7,0,1,0,0,1,0,9
1628,6,0,0,0,0,1,0,7
1629,5,0,1,0,0,0,0,6
1630,8,0,0,0,0,1,0,9
1631,11,0,0,0,0,1,0,12
1632,21,2,0,0,0,2,0,25
1633,2,0,0,0,0,3,0,5
1634,8,1,1,0,0,4,0,14
1635,11,1,1,0,0,2,0,15
1636,10,0,0,0,0,1,0,11
1637,7,0,1,0,0,1,0,9
1638,8,0,1,0,0,0,0,9
1639,2,1,0,0,0,3,0,6
1640,8,0,2,0,0,1,0,11
1641,8,0,0,0,0,2,0,10
1642,4,1,0,0,0,3,0,8
1643,5,1,0,0,0,2,0,8
1644,11,0,0,0,0,1,0,12
1645,4,0,1,0,0,1,0,6
1646,5,1,0,0,0,2,0,8
1647,12,0,1,0,0,2,0,15
1648,1,2,0,0,0,0,0,3
1649,7,0,0,0,0,0,0,7
1650,17,0,0,0,0,2,0,19
1651,4,0,0,0,0,5,0,9
1652,7,0,0,0,0,4,0,11
1653,8,0,0,0,0,1,0,9
1654,6,0,0,0,0,2,0,8
1655,4,0,0,0,0,5,0,9
1656,7,1,0,0,0,1,0,9
1657,3,0,0,0,0,0,0,3
1658,6,0,0,0,0,1,0,7
1659,8,0,0,0,0,0,0,8
1660,6,0,0,0,0,1,0,7
1661,7,1,0,0,0,0,0,8
1662,3,1,0,0,0,3,0,7
1663,6,0,0,0,0,2,0,8
1664,7,0,2,0,0,2,0,11
1665,4,0,0,0,0,2,0,6
1666,3,0,1,0,0,0,0,4
1667,3,0,0,0,0,1,0,4
1668,7,0,0,0,0,0,0,7
1669,5,0,0,0,0,5,0,10
1670,7,0,0,0,0,1,0,8
1671,8,0,0,0,0,5,0,13
1672,9,0,0,0,0,2,0,11
1673,8,0,0,0,0,3,0,11
1674,6,1,0,0,0,2,0,9
1675,6,0,1,0,0,4,0,11
1676,2,1,0,0,0,5,0,8
1677,3,0,0,0,0,1,0,4
1678,3,0,0,0,0,0,0,3
1679,8,0,0,0,0,1,0,9
1680,11,0,3,0,0,1,0,15
1681,8,0,0,0,0,2,0,10
1682,5,0,0,0,0,0,0,5
1683,10,0,0,0,0,4,0,14
1684,5,0,0,0,0,1,0,6
1685,10,0,0,0,0,4,0,14
1686,10,0,0,0,0,0,0,10
1687,5,0,1,0,0,2,0,8
1688,7,0,0,0,0,3,0,10
1689,10,0,1,0,0,0,0,11
1690,5,1,0,0,0,0,0,6
1691,3,1,0,0,0,1,0,5
1692,3,0,1,0,0,3,0,7
1693,3,0,0,0,0,1,0,4
1694,2,1,1,0,0,2,0,6
1695,9,1,1,0,0,3,0,14
1696,4,0,0,0,0,3,0,7
1697,7,0,0,0,0,0,0,7
1698,2,0,0,0,0,1,0,3
1699,6,0,0,0,0,1,0,7
1700,3,0,2,0,0,3,0,8
1701,9,0,0,0,0,0,0,9
1702,9,0,0,0,0,3,0,12
1703,4,0,1,0,0,0,0,5
1704,6,1,1,0,0,2,0,10
1705,5,0,0,0,0,1,0,6
1706,7,0,1,0,0,0,0,8
1707,5,1,1,0,0,2,0,9
1708,6,0,1,0,0,2,0,9
1709,4,0,1,0,0,1,0,6
1710,9,1,1,0,0,2,0,13
1711,8,1,0,0,0,0,0,9
1712,7,0,0,0,0,3,0,10
1713,5,0,0,0,0,0,0,5
1714,12,1,2,0,0,0,0,15
1715,4,0,0,0,0,0,0,4
1716,5,0,0,0,0,1,0,6
1717,4,1,0,0,0,3,0,8
1718,6,0,0,0,0,2,0,8
1719,8,0,1,0,0,1,0,10
1720,4,1,0,0,0,3,0,8
1721,7,0,0,0,0,2,0,9
1722,8,0,0,0,0,2,0,10
1723,7,0,0,0,0,0,0,7
1724,7,0,0,0,0,1,0,8
1725,8,0,0,0,0,2,0,10
1726,3,0,0,0,0,0,0,3
1727,7,0,0,0,0,1,0,8
1728,6,0,0,0,0,1,0,7
1729,5,1,0,0,0,2,0,8
1730,6,0,0,0,0,2,0,8
1731,5,0,1,0,0,2,0,8
1732,3,1,0,0,0,0,0,4
1733,4,0,1,0,0,1,0,6
1734,7,0,1,0,0,4,0,12
1735,3,0,0,0,0,0,0,3
1736,6,0,0,0,0,2,0,8
1737,8,0,0,0,0,0,0,8
1738,8,0,0,0,0,0,0,8
1739,8,1,0,0,0,2,0,11
1740,6,0,0,0,0,1,0,7
1741,9,2,0,0,0,2,0,13
1742,4,1,1,0,0,0,0,6
1743,1,0,0,0,0,1,0,2
1744,9,1,0,0,0,3,0,13
1745,6,1,0,0,0,4,0,11
1746,10,0,0,0,0,3,0,13
1747,4,1,0,0,0,2,0,7
1748,5,0,1,0,0,2,0,8
1749,5,0,0,0,0,2,0,7
1750,12,0,5,0,0,2,0,19
1751,11,0,0,0,0,1,0,12
1752,5,0,0,0,0,3,0,8
1753,4,1,1,0,0,1,0,7
1754,11,0,0,0,0,1,0,12
1755,6,0,0,0,0,1,0,7
1756,5,0,0,0,0,1,0,6
1757,9,0,0,0,0,0,0,9
1758,7,0,0,0,0,3,0,10
1759,3,1,1,0,0,2,0,7
1760,5,0,0,0,0,0,0,5
1761,8,0,1,0,0,1,0,10
1762,6,0,0,0,0,1,0,7
1763,3,1,0,0,0,0,0,4
1764,5,0,0,0,0,2,0,7
1765,6,0,0,0,0,1,0,7
1766,3,0,0,0,0,1,0,4
1767,6,0,0,0,0,1,0,7
1768,6,1,0,0,0,0,0,7
1769,3,0,1,0,0,5,0,9
1770,6,1,2,0,0,4,0,13
1771,9,0,0,0,0,3,0,12
1772,10,0,0,0,0,1,0,11
1773,4,0,2,0,0,0,0,6
1774,9,0,0,0,0,1,0,10
1775,7,0,0,0,0,1,0,8
1776,11,0,0,0,0,0,0,11
1777,3,0,0,0,0,0,0,3
1778,4,0,0,0,0,0,0,4
1779,7,1,0,0,0,1,0,9
1780,7,0,0,0,0,2,0,9
1781,9,0,0,0,0,1,0,10
1782,7,0,0,0,0,0,0,7
1783,5,1,0,0,0,2,0,8
1784,10,0,0,0,0,5,0,15
1785,7,1,0,0,0,1,0,9
1786,7,0,0,0,0,2,0,9
1787,5,0,0,0,0,4,0,9
1788,6,1,0,0,0,0,0,7
1789,7,0,0,0,0,2,0,9
1790,7,0,0,0,0,4,0,11
1791,4,0,0,0,0,3,0,7
1792,5,1,1,0,0,1,0,8
1793,2,0,1,0,0,0,0,3
1794,9,0,0,0,0,1,0,10
1795,6,0,3,0,0,5,0,14
1796,3,0,0,0,0,2,0,5
1797,9,0,0,0,0,1,0,10
1798,1,0,0,0,0,1,0,2
1799,7,0,0,0,0,0,0,7
1800,6,0,1,0,0,0,0,7
1801,6,0,1,0,0,1,0,8
1802,7,0,0,0,0,2,0,9
1803,4,0,0,0,0,0,0,4
1804,2,0,0,0,0,4,0,6
1805,3,0,0,0,0,1,0,4
1806,4,0,0,0,0,2,0,6
1807,8,1,0,0,0,1,0,10
1808,2,0,0,0,0,1,0,3
1809,4,1,1,0,0,0,0,6
1810,8,0,0,0,0,1,0,9
1811,4,0,0,0,0,3,0,7
1812,6,0,1,0,0,0,0,7
1813,6,0,0,0,0,2,0,8
1814,9,0,0,0,0,2,0,11
1815,2,0,0,0,0,1,0,3
1816,5,0,0,0,0,1,0,6
1817,3,0,0,0,0,4,0,7
1818,1,0,1,0,0,3,0,5
1819,5,0,1,0,0,1,0,7
1820,4,0,0,0,0,0,0,4
1821,5,0,0,0,0,5,0,10
1822,8,0,1,0,0,1,0,10
1823,6,1,0,0,0,1,0,8
1824,7,1,0,0,0,0,0,8
1825,3,1,0,0,0,2,0,6
1826,3,0,3,0,0,2,0,8
1827,4,0,0,0,0,2,0,6
1828,8,0,0,0,0,2,0,10
1829,8,0,0,0,0,2,0,10
1830,12,1,0,0,0,2,0,15
1831,3,0,0,0,0,1,0,4
1832,6,1,1,0,0,4,0,12
1833,6,1,0,0,0,0,0,7
1834,6,1,0,0,0,0,0,7
1835,3,0,0,0,0,1,0,4
1836,6,0,1,0,0,2,0,9
1837,7,0,2,0,0,2,0,11
1838,6,1,2,0,0,3,0,12
1839,3,0,0,0,0,0,0,3
1840,9,0,0,0,0,2,0,11
1841,5,0,0,0,0,0,0,5
1842,7,1,0,0,0,1,0,9
1843,5,1,0,0,0,3,0,9
1844,6,0,1,0,0,2,0,9
1845,6,2,0,0,0,2,0,10
1846,4,1,1,0,0,1,0,7
1847,2,0,1,0,0,1,0,4
1848,2,0,0,0,0,3,0,5
1849,5,0,1,0,0,1,0,7
1850,3,0,1,0,0,1,0,5
1851,3,0,0,0,0,0,0,3
1852,7,0,0,0,0,2,0,9
1853,9,0,1,0,0,1,0,11
1854,8,0,0,0,0,0,0,8
1855,2,0,0,0,0,1,0,3
1856,5,0,0,0,0,0,0,5
1857,7,0,0,0,0,2,0,9
1858,3,0,0,0,0,1,0,4
1859,3,0,0,0,0,0,0,3
1860,6,0,0,0,0,2,0,8
1861,3,0,0,0,0,1,0,4
1862,8,0,0,0,0,0,0,8
1863,4,0,0,0,0,1,0,5
1864,10,0,0,0,0,1,0,11
1865,6,0,0,0,0,1,0,7
1866,6,1,0,0,0,1,0,8
1867,5,0,0,0,0,0,0,5
1868,5,1,0,0,0,2,0,8
1869,5,0,0,0,0,1,0,6
1870,7,0,1,0,0,3,0,11
1871,7,0,0,0,0,3,0,10
1872,8,1,0,0,0,2,0,11
1873,1,1,0,0,0,3,0,5
1874,1,0,0,0,0,1,0,2
1875,5,0,1,0,0,2,0,8
1876,0,0,0,0,0,1,0,1
1877,5,0,1,0,0,3,0,9
1878,3,0,1,0,0,1,0,5
1879,0,1,1,0,0,3,0,5
1880,4,1,1,0,0,1,0,7
1881,6,0,0,0,0,5,0,11
1882,4,0,0,0,0,3,0,7
1883,2,0,0,0,0,1,0,3
1884,10,0,0,0,0,1,0,11
1885,3,1,1,0,0,3,0,8
1886,3,0,1,0,0,0,0,4
1887,2,0,1,0,0,1,0,4
1888,5,1,0,0,0,0,0,6
1889,3,0,0,0,0,1,0,4
1890,9,0,0,0,0,2,0,11
1891,3,0,0,0,0,0,0,3
1892,5,1,1,0,0,3,0,10
1893,7,0,0,0,0,1,0,8
1894,4,0,1,0,0,1,0,6
1895,8,0,0,0,0,0,0,8
1896,4,0,0,0,0,1,0,5
1897,5,0,1,0,0,4,0,10
1898,5,0,1,0,0,1,0,7
1899,8,0,0,0,0,0,0,8
1900,5,0,1,0,0,1,0,7
1901,6,2,1,0,0,1,0,10
1902,9,0,1,0,0,3,0,13
1903,5,1,0,0,0,1,0,7
1904,5,0,0,0,0,3,0,8
1905,7,0,1,0,0,4,0,12
1906,1,0,0,0,0,3,0,4
1907,5,0,0,0,0,0,0,5
1908,7,0,0,0,0,2,0,9
1909,7,0,1,0,0,2,0,10
1910,4,0,0,0,0,2,0,6
1911,4,0,0,0,0,0,0,4
1912,7,0,0,0,0,2,0,9
1913,1,0,0,0,0,1,0,2
1914,6,0,0,0,0,1,0,7
1915,2,0,0,0,0,0,0,2
1916,4,0,0,0,0,2,0,6
1917,4,0,1,0,0,1,0,6
1918,2,0,0,0,0,1,0,3
1919,12,0,0,0,0,0,0,12
1920,9,0,1,0,0,2,0,12
1921,4,1,0,0,0,0,0,5
1922,6,0,2,0,0,1,0,9
1923,1,0,0,0,0,1,0,2
1924,8,0,0,0,0,1,0,9
1925,6,1,0,0,0,3,0,10
1926,4,1,0,0,0,2,0,7
1927,5,0,1,0,0,0,0,6
1928,2,1,0,0,0,0,0,3
1929,3,0,1,0,0,4,0,8
1930,7,0,0,0,0,4,0,11
1931,2,0,0,0,0,1,0,3
1932,9,0,0,0,0,0,0,9
1933,5,0,0,0,0,4,0,9
1934,2,0,0,0,0,0,0,2
1935,7,1,0,0,0,1,0,9
1936,6,0,0,0,0,1,0,7
1937,6,0,0,0,0,1,0,7
1938,7,1,0,0,0,0,0,8
1939,4,0,0,0,0,1,0,5
1940,7,0,1,0,0,1,0,9
1941,7,0,0,0,0,0,0,7
1942,5,0,0,0,0,0,0,5
1943,3,1,0,0,0,1,0,5
1944,4,1,0,0,0,0,0,5
1945,6,0,0,0,0,0,0,6
1946,4,0,0,0,0,1,0,5
1947,2,0,1,0,0,1,0,4
1948,9,1,0,0,0,2,0,12
1949,3,0,0,0,0,1,0,4
1950,4,1,0,0,0,0,0,5
1951,2,0,0,0,0,2,0,4
1952,8,1,0,0,0,0,0,9
1953,3,0,0,0,0,0,0,3
1954,7,0,0,0,0,0,0,7
1955,6,0,2,0,0,0,0,8
1956,4,0,0,0,0,2,0,6
1957,5,0,0,0,0,0,0,5
1958,15,0,4,0,0,3,0,22
1959,5,0,0,0,0,1,0,6
1960,8,0,0,0,0,0,0,8
1961,4,0,0,0,0,1,0,5
1962,2,0,0,0,0,0,0,2
1963,4,0,0,0,0,2,0,6
1964,3,1,0,0,0,1,0,5
1965,6,0,0,0,0,2,0,8
1966,2,1,0,0,0,0,0,3
1967,2,0,1,0,0,2,0,5
1968,3,0,0,0,0,0,0,3
1969,3,0,0,0,0,2,0,5
1970,6,1,0,0,0,3,0,10
1971,3,0,0,0,0,3,0,6
1972,8,1,1,0,0,1,0,11
1973,2,0,0,0,0,0,0,2
1974,4,0,0,0,0,1,0,5
1975,2,0,0,0,0,2,0,4
1976,4,0,0,0,0,1,0,5
1977,3,0,0,0,0,0,0,3
1978,6,0,0,0,0,0,0,6
1979,5,0,0,0,0,2,0,7
1980,12,0,1,0,0,2,0,15
1981,5,0,0,0,0,1,0,6
1982,7,1,0,0,0,0,0,8
1983,7,0,2,0,0,1,0,10
1984,1,0,0,0,0,0,0,1
1985,8,0,1,0,0,2,0,11
1986,5,0,0,0,0,1,0,6
1987,6,0,0,0,0,0,0,6
1988,1,0,0,0,0,2,0,3
1989,3,0,0,0,0,0,0,3
1990,3,0,1,0,0,0,0,4
1991,3,0,1,0,0,1,0,5
1992,4,0,1,0,0,3,0,8
1993,4,1,0,0,0,0,0,5
1994,2,1,0,0,0,0,0,3
1995,1,1,1,0,0,0,0,3
1996,8,0,0,0,0,0,0,8
1997,5,0,0,0,0,0,0,5
1998,7,0,1,0,0,1,0,9
1999,4,0,0,0,0,0,0,4
2000,2,1,1,0,0,1,0,5
2001,6,0,0,0,0,0,0,6
2002,2,0,0,0,0,2,0,4
2003,10,0,1,0,0,0,0,11
2004,2,0,0,0,0,0,0,2
2005,6,0,0,0,0,1,0,7
2006,6,0,0,0,0,0,0,6
2007,3,0,0,0,0,0,0,3
2008,3,0,1,0,0,0,0,4
2009,1,0,0,0,0,0,0,1
2010,6,0,0,0,0,0,0,6
2011,4,0,1,0,0,0,0,5
2012,1,0,0,0,0,0,0,1
2013,3,0,0,0,0,1,0,4
2014,3,0,0,0,0,0,0,3
2015,5,0,0,0,0,1,0,6
2016,4,0,1,0,0,0,0,5
2017,4,0,0,0,0,0,0,4
2018,5,1,0,0,0,3,0,9
2019,2,0,1,0,0,0,0,3
2020,6,0,0,0,0,3,0,9
2021,2,0,2,0,0,1,0,5
2022,4,0,0,0,0,0,0,4
2023,2,0,0,0,0,3,0,5
2024,9,0,0,0,0,0,0,9
2025,7,1,1,0,0,1,0,10
2026,2,2,0,0,0,1,0,5
2027,3,1,1,0,0,0,0,5
2028,2,0,1,0,0,0,0,3
2029,1,0,0,0,0,0,0,1
2030,2,0,0,0,0,0,0,2
2031,5,0,0,0,0,1,0,6
2032,5,0,0,0,0,1,0,6
2033,6,1,1,0,0,1,0,9
2034,4,0,0,0,0,1,0,5
2035,6,0,1,0,0,0,0,7
2036,3,0,0,0,0,0,0,3
2037,2,0,1,0,0,1,0,4
2038,6,0,0,0,0,0,0,6
2039,2,0,0,0,0,0,0,2
2040,6,0,0,0,0,2,0,8
2041,5,1,0,0,0,0,0,6
2042,4,0,0,0,0,2,0,6
2043,2,0,0,0,0,3,0,5
2044,3,0,0,0,0,0,0,3
2045,5,0,0,0,0,0,0,5
2046,8,0,0,0,0,0,0,8
2047,6,0,1,0,0,0,0,7
2048,3,1,0,0,0,1,0,5
2049,4,0,0,0,0,0,0,4
2050,4,0,1,0,0,0,0,5
2051,4,0,0,0,0,0,0,4
2052,7,0,0,0,0,1,0,8
2053,2,1,0,0,0,0,0,3
2054,2,0,1,0,0,0,0,3
2055,4,0,0,0,0,0,0,4
2056,5,0,0,0,0,1,0,6
2057,2,2,1,0,0,2,0,7
2058,3,1,2,0,0,3,0,9
2059,3,0,0,0,0,0,0,3
2060,2,0,0,0,0,1,0,3
2061,5,0,0,0,0,2,0,7
2062,4,0,0,0,0,1,0,5
2063,6,0,0,0,0,1,0,7
2064,1,0,0,0,0,0,0,1
2065,2,1,1,0,0,0,0,4
2066,3,0,1,0,0,1,0,5
2067,5,0,0,0,0,1,0,6
2068,2,0,0,0,0,2,0,4
2069,6,1,0,0,0,0,0,7
2070,7,0,0,0,0,3,0,10
2071,1,0,0,0,0,0,0,1
2072,7,0,0,0,0,2,0,9
2073,7,0,0,0,0,1,0,8
2074,2,0,1,0,0,1,0,4
2075,5,1,1,0,0,0,0,7
2076,6,0,0,0,0,0,0,6
2077,8,1,0,0,0,1,0,10
2078,6,1,0,0,0,0,0,7
2079,4,0,0,0,0,0,0,4
2080,10,0,0,0,0,1,0,11
2081,7,0,1,0,0,1,0,9
2082,3,0,0,0,0,1,0,4
2083,1,0,1,0,0,0,0,2
2084,9,0,2,0,0,1,0,12
2085,5,0,1,0,0,2,0,8
2086,4,0,0,0,0,0,0,4
2087,3,0,1,0,0,0,0,4
2088,5,0,0,0,0,0,0,5
2089,6,0,0,0,0,0,0,6
2090,5,0,0,0,0,0,0,5
2091,2,0,1,0,0,1,0,4
2092,4,0,1,0,0,2,0,7
2093,2,1,0,0,0,1,0,4
2094,3,0,0,0,0,2,0,5
2095,6,0,0,0,0,1,0,7
2096,2,0,0,0,0,0,0,2
2097,4,0,0,0,0,1,0,5
2098,4,0,0,0,0,1,0,5
2099,0,0,0,0,0,2,0,2
2100,8,0,0,0,0,2,0,10
2101,1,0,0,0,0,1,0,2
2102,5,0,0,0,0,0,0,5
2103,6,0,0,0,0,1,0,7
2104,5,0,0,0,0,2,0,7
2105,6,0,0,0,0,1,0,7
2106,5,0,0,0,0,0,0,5
2107,0,1,0,0,0,0,0,1
2108,5,0,0,0,0,0,0,5
2109,6,0,0,0,0,0,0,6
2110,3,0,0,0,0,1,0,4
2111,5,0,0,0,0,0,0,5
2112,3,0,0,0,0,2,0,5
2113,2,0,0,0,0,0,0,2
2114,0,1,0,0,0,0,0,1
2115,9,0,0,0,0,2,0,11
2116,5,0,0,0,0,0,0,5
2117,0,0,0,0,0,2,0,2
2118,3,1,0,0,0,1,0,5
2119,4,0,0,0,0,0,0,4
2120,4,0,0,0,0,1,0,5
2122,11,0,0,0,0,0,0,11
2123,4,0,0,0,0,0,0,4
2124,2,0,0,0,0,1,0,3
2125,2,0,0,0,0,2,0,4
2126,1,0,0,0,0,0,0,1
2127,1,0,0,0,0,1,0,2
2128,2,0,1,0,0,0,0,3
2129,2,0,0,0,0,1,0,3
2130,6,0,1,0,0,3,0,10
2131,0,0,1,0,0,1,0,2
2132,4,1,0,0,0,0,0,5
2133,4,0,0,0,0,0,0,4
2134,7,0,0,0,0,1,0,8
2135,2,0,1,0,0,0,0,3
2136,4,0,0,0,0,0,0,4
2137,4,0,0,0,0,2,0,6
2138,4,0,0,0,0,0,0,4
2139,5,0,0,0,0,0,0,5
2140,0,0,0,0,0,1,0,1
2141,2,1,1,0,0,1,0,5
2142,8,0,1,0,0,0,0,9
2143,6,1,0,0,0,1,0,8
2144,3,0,0,0,0,1,0,4
2145,8,1,0,0,0,2,0,11
2146,7,0,0,0,0,3,0,10
2147,6,0,0,0,0,2,0,8
2148,5,1,0,0,0,1,0,7
2149,4,1,0,0,0,0,0,5
2150,7,0,0,0,0,2,0,9
2151,2,0,0,0,0,1,0,3
2152,3,0,1,0,0,0,0,4
2153,4,1,0,0,0,0,0,5
2154,4,0,0,0,0,0,0,4
2155,3,1,0,0,0,2,0,6
2156,4,0,0,0,0,2,0,6
2157,3,0,0,0,0,1,0,4
2158,1,0,0,0,0,1,0,2
2159,3,0,1,0,0,0,0,4
2160,7,1,1,0,0,1,0,10
2161,2,0,1,0,0,0,0,3
2162,6,0,0,0,0,1,0,7
2163,3,0,0,0,0,1,0,4
2164,3,0,0,0,0,1,0,4
2165,4,0,0,0,0,2,0,6
2166,1,1,1,0,0,0,0,3
2167,6,0,1,0,0,0,0,7
2168,5,0,0,0,0,1,0,6
2169,2,0,0,0,0,0,0,2
2170,9,0,1,0,0,0,0,10
2171,2,0,0,0,0,2,0,4
2172,4,0,0,0,0,0,0,4
2173,6,0,0,0,0,1,0,7
2174,4,0,0,0,0,2,0,6
2175,4,1,0,0,0,0,0,5
2176,3,0,0,0,0,0,0,3
2177,2,0,0,0,0,0,0,2
2178,3,0,0,0,0,1,0,4
2179,7,0,0,0,0,1,0,8
2180,4,0,0,0,0,0,0,4
2181,2,0,0,0,0,0,0,2
2182,4,0,0,0,0,0,0,4
2183,3,0,0,0,0,2,0,5
2184,3,1,0,0,0,0,0,4
2185,3,1,0,0,0,0,0,4
2186,2,0,0,0,0,1,0,3
2187,3,0,0,0,0,2,0,5
2188,2,0,0,0,0,0,0,2
2189,4,0,0,0,0,1,0,5
2190,4,1,0,0,0,0,0,5
2191,2,0,0,0,0,0,0,2
2192,5,0,0,0,0,1,0,6
2193,2,0,0,0,0,0,0,2
2194,5,1,1,0,0,2,0,9
2195,2,0,0,0,0,0,0,2
2196,3,0,0,0,0,0,0,3
2197,2,1,0,0,0,0,0,3
2198,4,1,0,0,0,0,0,5
2199,1,0,0,0,0,1,0,2
2200,5,0,0,0,0,1,0,6
2201,2,0,0,0,0,0,0,2
2202,5,0,0,0,0,0,0,5
2203,7,2,1,0,0,2,0,12
2204,3,0,0,0,0,1,0,4
2205,4,0,0,0,0,0,0,4
2206,3,0,0,0,0,0,0,3
2207,4,0,0,0,0,3,0,7
2208,1,0,0,0,0,0,0,1
2209,3,0,0,0,0,0,0,3
2210,5,0,0,0,0,0,0,5
2211,2,0,2,0,0,0,0,4
2212,7,1,0,0,0,1,0,9
2213,1,0,0,0,0,0,0,1
2214,9,2,0,0,0,0,0,11
2215,4,0,1,0,0,0,0,5
2216,5,0,0,0,0,0,0,5
2217,5,0,0,0,0,0,0,5
2218,4,0,1,0,0,0,0,5
2219,6,0,2,0,0,0,0,8
2220,4,0,0,0,0,2,0,6
2221,2,1,0,0,0,0,0,3
2222,4,0,0,0,0,1,0,5
2223,3,1,0,0,0,0,0,4
2224,3,0,0,0,0,0,0,3
2225,1,0,0,0,0,1,0,2
2226,2,0,3,0,0,1,0,6
2227,4,0,1,0,0,0,0,5
2228,4,1,0,0,0,1,0,6
2229,3,0,0,0,0,1,0,4
2230,5,0,0,0,0,0,0,5
2231,5,0,2,0,0,2,0,9
2232,6,0,0,0,0,0,0,6
2233,1,0,0,0,0,0,0,1
2234,2,0,0,0,0,0,0,2
2235,2,0,0,0,0,0,0,2
2236,3,0,1,0,0,0,0,4
2237,3,1,0,0,0,1,0,5
2238,8,0,0,0,0,0,0,8
2239,3,0,0,0,0,2,0,5
2240,6,0,0,0,0,1,0,7
2241,4,0,0,0,0,0,0,4
2242,5,0,0,0,0,0,0,5
2243,4,1,0,0,0,2,0,7
2244,2,1,0,0,0,0,0,3
2245,5,0,0,0,0,0,0,5
2246,5,0,0,0,0,0,0,5
2247,6,1,0,0,0,1,0,8
2248,5,1,0,0,0,1,0,7
2249,2,0,0,0,0,0,0,2
2250,4,0,0,0,0,1,0,5
2251,2,0,0,0,0,0,0,2
2252,2,0,0,0,0,1,0,3
2253,5,0,0,0,0,0,0,5
2254,5,1,1,0,0,1,0,8
2255,1,0,0,0,0,1,0,2
2256,1,0,0,0,0,0,0,1
2257,4,0,0,0,0,2,0,6
2258,4,0,0,0,0,0,0,4
2259,3,0,0,0,0,0,0,3
2260,5,1,1,0,0,0,0,7
2261,4,0,1,0,0,1,0,6
2262,5,1,0,0,0,0,0,6
2263,3,0,0,0,0,3,0,6
2264,6,1,0,0,0,1,0,8
2265,5,0,0,0,0,0,0,5
2266,4,0,0,0,0,2,0,6
2267,1,0,0,0,0,1,0,2
2268,4,0,0,0,0,0,0,4
2269,0,0,0,0,0,1,0,1
2270,3,0,0,0,0,2,0,5
2271,2,0,0,0,0,1,0,3
2272,1,0,1,0,0,0,0,2
2273,2,0,0,0,0,1,0,3
2274,3,0,0,0,0,1,0,4
2275,3,0,0,0,0,1,0,4
2276,2,0,0,0,0,1,0,3
2277,3,0,0,0,0,1,0,4
2278,2,0,0,0,0,2,0,4
2279,0,0,0,0,0,1,0,1
2280,8,1,0,0,0,2,0,11
2281,4,0,0,0,0,0,0,4
2283,5,0,0,0,0,1,0,6
2284,5,0,0,0,0,1,0,6
2285,5,0,0,0,0,0,0,5
2286,3,0,0,0,0,0,0,3
2288,2,0,0,0,0,1,0,3
2289,4,0,1,0,0,2,0,7
2290,2,0,2,0,0,0,0,4
2291,4,0,0,0,0,0,0,4
2292,2,0,0,0,0,2,0,4
2293,4,0,0,0,0,0,0,4
2294,5,0,0,0,0,0,0,5
2295,3,0,1,0,0,1,0,5
2296,1,0,0,0,0,1,0,2
2297,1,0,0,0,0,1,0,2
2298,3,0,0,0,0,0,0,3
2299,2,0,0,0,0,1,0,3
2300,3,0,0,0,0,0,0,3
2301,2,2,0,0,0,1,0,5
2302,1,1,0,0,0,1,0,3
2303,6,0,0,0,0,0,0,6
2304,3,2,0,0,0,0,0,5
2305,3,0,1,0,0,0,0,4
2306,1,0,0,0,0,0,0,1
2307,7,0,0,0,0,0,0,7
2308,4,0,0,0,0,0,0,4
2309,1,0,0,0,0,1,0,2
2310,3,0,0,0,0,1,0,4
2311,5,1,0,0,0,0,0,6
2312,3,1,1,0,0,0,0,5
2313,3,0,1,0,0,3,0,7
2314,4,0,0,0,0,0,0,4
2315,4,0,0,0,0,1,0,5
2316,3,0,0,0,0,1,0,4
2317,3,0,0,0,0,0,0,3
2318,6,0,0,0,0,0,0,6
2319,2,0,0,0,0,0,0,2
2320,4,0,0,0,0,1,0,5
2321,1,0,0,0,0,0,0,1
2322,3,0,1,0,0,0,0,4
2323,4,0,0,0,0,0,0,4
2324,3,0,0,0,0,0,0,3
2325,3,0,1,0,0,1,0,5
2326,11,2,0,0,0,1,0,14
2327,3,1,0,0,0,0,0,4
2328,2,0,0,0,0,1,0,3
2329,6,0,0,0,0,0,0,6
2330,4,0,0,0,0,0,0,4
2331,2,0,0,0,0,0,0,2
2332,2,0,0,0,0,0,0,2
2333,4,0,0,0,0,0,0,4
2334,1,0,0,0,0,1,0,2
2335,1,0,0,0,0,1,0,2
2336,6,0,1,0,0,0,0,7
2337,3,0,0,0,0,2,0,5
2338,1,0,0,0,0,4,0,5
2339,4,0,0,0,0,0,0,4
2340,2,0,0,0,0,2,0,4
2341,3,0,0,0,0,0,0,3
2342,3,0,0,0,0,0,0,3
2343,2,0,0,0,0,1,0,3
2344,6,0,0,0,0,2,0,8
2345,6,0,0,0,0,1,0,7
2346,4,0,0,0,0,1,0,5
2347,3,0,0,0,0,3,0,6
2348,2,0,0,0,0,1,0,3
2349,2,0,1,0,0,0,0,3
2350,5,0,0,0,0,0,0,5
2351,4,0,0,0,0,1,0,5
2352,2,0,0,0,0,1,0,3
2353,2,0,0,0,0,0,0,2
2354,2,1,0,0,0,0,0,3
2355,5,1,0,0,0,1,0,7
2356,1,0,0,0,0,1,0,2
2357,5,0,0,0,0,1,0,6
2358,1,0,0,0,0,1,0,2
2359,3,0,0,0,0,1,0,4
2360,6,0,1,0,0,1,0,8
2361,3,1,0,0,0,0,0,4
2362,3,0,0,0,0,0,0,3
2363,4,0,1,0,0,0,0,5
2364,4,1,1,0,0,0,0,6
2365,5,0,0,0,0,1,0,6
2366,3,1,0,0,0,1,0,5
2367,1,1,1,0,0,0,0,3
2368,1,0,0,0,0,1,0,2
2369,2,1,0,0,0,1,0,4
2370,1,0,0,0,0,1,0,2
2371,1,0,0,0,0,1,0,2
2372,2,0,0,0,0,0,0,2
2373,6,0,1,0,0,1,0,8
2374,1,0,0,0,0,0,0,1
2375,2,1,0,0,0,2,0,5
2376,2,0,0,0,0,0,0,2
2377,1,1,0,0,0,0,0,2
2378,2,0,0,0,0,0,0,2
2379,5,0,0,0,0,2,0,7
2380,3,0,1,0,0,0,0,4
2381,2,0,1,0,0,0,0,3
2383,2,1,0,0,0,0,0,3
2384,1,0,1,0,0,1,0,3
2385,1,0,0,0,0,0,0,1
2386,5,0,0,0,0,0,0,5
2387,6,0,1,0,0,0,0,7
2388,8,1,1,0,0,0,0,10
2389,1,0,0,0,0,1,0,2
2390,1,0,0,0,0,0,0,1
2391,2,0,0,0,0,0,0,2
2392,3,0,0,0,0,2,0,5
2393,2,0,0,0,0,0,0,2
2394,4,1,0,0,0,2,0,7
2395,3,0,0,0,0,1,0,4
2396,1,0,0,0,0,1,0,2
2397,2,0,0,0,0,0,0,2
2398,4,1,0,0,0,0,0,5
2399,1,1,0,0,0,1,0,3
2400,6,1,1,0,0,1,0,9
2401,3,0,0,0,0,0,0,3
2402,2,0,0,0,0,0,0,2
2403,3,0,0,0,0,0,0,3
2404,4,0,0,0,0,0,0,4
2405,3,0,0,0,0,1,0,4
2406,2,0,1,0,0,0,0,3
2407,2,0,1,0,0,0,0,3
2408,2,0,0,0,0,0,0,2
2409,5,0,0,0,0,2,0,7
2410,3,0,0,0,0,1,0,4
2411,4,1,0,0,0,1,0,6
2412,2,0,1,0,0,0,0,3
2413,5,0,0,0,0,0,0,5
2414,3,0,1,0,0,0,0,4
2415,4,0,0,0,0,0,0,4
2416,3,0,0,0,0,0,0,3
2417,7,0,0,0,0,0,0,7
2419,4,0,0,0,0,0,0,4
2420,4,1,0,0,0,1,0,6
2421,4,0,0,0,0,0,0,4
2422,0,0,0,0,0,2,0,2
2423,5,0,1,0,0,0,0,6
2424,3,0,1,0,0,0,0,4
2425,4,0,0,0,0,0,0,4
2427,5,1,0,0,0,0,0,6
2428,0,0,0,0,0,1,0,1
2429,2,0,0,0,0,0,0,2
2430,3,0,0,0,0,0,0,3
2431,2,0,0,0,0,1,0,3
2432,3,0,0,0,0,0,0,3
2433,0,0,0,0,0,2,0,2
2434,4,0,0,0,0,0,0,4
2435,1,0,1,0,0,0,0,2
2436,2,0,0,0,0,1,0,3
2437,1,0,1,0,0,0,0,2
2438,3,1,0,0,0,2,0,6
2439,4,0,2,0,0,1,0,7
2441,2,0,0,0,0,1,0,3
2442,3,0,0,0,0,0,0,3
2443,1,0,0,0,0,1,0,2
2444,3,0,1,0,0,0,0,4
2445,3,0,0,0,0,1,0,4
2446,6,0,0,0,0,0,0,6
2447,0,0,1,0,0,0,0,1
2448,10,2,2,0,0,1,0,15
2449,1,0,0,0,0,0,0,1
2450,4,0,1,0,0,0,0,5
2451,2,0,0,0,0,0,0,2
2452,0,0,1,0,0,0,0,1
2453,2,0,0,0,0,0,0,2
2454,0,1,0,0,0,0,0,1
2455,5,0,0,0,0,0,0,5
2456,1,0,0,0,0,0,0,1
2457,2,0,0,0,0,1,0,3
2458,7,0,0,0,0,0,0,7
2459,4,1,0,0,0,0,0,5
2460,2,0,0,0,0,1,0,3
2461,5,1,0,0,0,1,0,7
2462,1,0,0,0,0,0,0,1
2463,1,0,1,0,0,0,0,2
2464,3,0,0,0,0,0,0,3
2465,4,1,0,0,0,1,0,6
2466,2,1,1,0,0,0,0,4
2467,5,1,0,0,0,1,0,7
2468,4,0,0,0,0,0,0,4
2469,3,0,0,0,0,1,0,4
2470,1,0,0,0,0,1,0,2
2471,1,0,1,0,0,0,0,2
2472,3,0,0,0,0,0,0,3
2473,5,0,0,0,0,1,0,6
2474,5,0,1,0,0,0,0,6
2475,3,0,0,0,0,0,0,3
2476,1,0,0,0,0,2,0,3
2477,1,1,0,0,0,0,0,2
2478,2,0,0,0,0,0,0,2
2479,2,0,0,0,0,0,0,2
2480,4,0,0,0,0,0,0,4
2481,3,0,0,0,0,0,0,3
2482,1,0,0,0,0,1,0,2
2483,2,0,0,0,0,0,0,2
2484,1,1,0,0,0,0,0,2
2485,5,0,0,0,0,0,0,5
2486,5,0,0,0,0,1,0,6
2487,2,0,0,0,0,0,0,2
2488,5,0,1,0,0,1,0,7
2489,6,0,0,0,0,0,0,6
2490,6,0,0,0,0,0,0,6
2491,2,1,0,0,0,1,0,4
2492,4,0,0,0,0,0,0,4
2493,2,0,0,0,0,0,0,2
2494,3,0,0,0,0,1,0,4
2495,2,0,0,0,0,0,0,2
2496,1,0,0,0,0,0,0,1
2497,1,0,0,0,0,0,0,1
2498,1,0,1,0,0,0,0,2
2499,0,0,1,0,0,0,0,1
2500,6,0,0,0,0,0,0,6
2501,3,0,0,0,0,1,0,4
2502,1,0,1,0,0,0,0,2
2503,5,0,0,0,0,0,0,5
2504,4,0,0,0,0,0,0,4
2505,0,0,3,0,0,0,0,3
2506,4,0,0,0,0,0,0,4
2507,2,0,0,0,0,0,0,2
2508,3,0,0,0,0,0,0,3
2509,3,0,1,0,0,1,0,5
2510,4,0,1,0,0,0,0,5
2511,3,1,0,0,0,0,0,4
2512,4,0,0,0,0,0,0,4
2513,2,0,0,0,0,2,0,4
2514,5,0,0,0,0,1,0,6
2515,4,0,0,0,0,1,0,5
2516,1,0,0,0,0,0,0,1
2517,1,1,0,0,0,0,0,2
2518,4,0,0,0,0,0,0,4
2519,4,1,0,0,0,1,0,6
2520,3,0,1,0,0,0,0,4
2521,3,0,0,0,0,0,0,3
2522,1,0,0,0,0,1,0,2
2523,3,0,0,0,0,0,0,3
2524,3,0,0,0,0,0,0,3
2525,1,0,0,0,0,0,0,1
2526,4,0,0,0,0,0,0,4
2527,3,0,1,0,0,1,0,5
2528,2,0,0,0,0,0,0,2
2529,3,0,0,0,0,0,0,3
2530,3,1,1,0,0,1,0,6
2531,6,0,0,0,0,0,0,6
2532,0,0,0,0,0,1,0,1
2533,0,0,0,0,0,1,0,1
2535,4,0,0,0,0,0,0,4
2536,2,0,0,0,0,0,0,2
2537,8,0,0,0,0,2,0,10
2538,1,0,1,0,0,0,0,2
2539,3,0,0,0,0,0,0,3
2540,1,0,1,0,0,2,0,4
2541,2,0,0,0,0,1,0,3
2542,4,0,0,0,0,1,0,5
2543,3,0,0,0,0,0,0,3
2544,2,0,0,0,0,0,0,2
2546,7,0,0,0,0,1,0,8
2547,2,0,0,0,0,0,0,2
2548,1,0,0,0,0,0,0,1
2549,1,1,0,0,0,0,0,2
2550,3,0,1,0,0,0,0,4
2551,3,0,0,0,0,0,0,3
2552,3,0,0,0,0,1,0,4
2553,1,0,0,0,0,0,0,1
2554,3,0,0,0,0,0,0,3
2555,4,0,0,0,0,1,0,5
2556,2,0,0,0,0,0,0,2
2557,2,0,0,0,0,0,0,2
2558,1,0,0,0,0,0,0,1
2559,2,0,0,0,0,0,0,2
2560,6,1,0,0,0,1,0,8
2561,6,0,0,0,0,1,0,7
2562,2,0,0,0,0,0,0,2
2563,2,1,0,0,0,0,0,3
2564,4,0,0,0,0,0,0,4
2565,2,0,0,0,0,0,0,2
2566,2,0,0,0,0,0,0,2
2567,3,0,0,0,0,0,0,3
2568,3,0,0,0,0,0,0,3
2569,2,0,0,0,0,0,0,2
2570,4,0,1,0,0,1,0,6
2571,3,0,1,0,0,1,0,5
2572,4,1,0,0,0,1,0,6
2573,2,1,1,0,0,0,0,4
2574,2,0,1,0,0,0,0,3
2575,3,0,0,0,0,0,0,3
2576,3,0,0,0,0,0,0,3
2577,5,1,0,0,0,0,0,6
2578,3,0,0,0,0,0,0,3
2579,1,0,0,0,0,1,0,2
2580,2,0,0,0,0,0,0,2
2581,3,0,0,0,0,1,0,4
2582,1,0,0,0,0,2,0,3
2583,3,2,0,0,0,0,0,5
2584,2,0,0,0,0,0,0,2
2585,2,0,0,0,0,0,0,2
2586,4,0,1,0,0,0,0,5
2587,5,0,1,0,0,0,0,6
2588,1,0,0,0,0,1,0,2
2589,3,0,0,0,0,1,0,4
2590,4,0,0,0,0,0,0,4
2591,5,0,0,0,0,0,0,5
2592,1,0,0,0,0,0,0,1
2593,2,0,0,0,0,0,0,2
2594,2,0,0,0,0,0,0,2
2595,2,0,0,0,0,0,0,2
2596,4,0,0,0,0,0,0,4
2597,2,0,0,0,0,0,0,2
2598,2,0,0,0,0,0,0,2
2599,3,0,0,0,0,0,0,3
2600,1,0,0,0,0,0,0,1
2601,1,0,0,0,0,0,0,1
2602,2,0,0,0,0,1,0,3
2604,2,0,0,0,0,1,0,3
2605,2,0,0,0,0,0,0,2
2606,3,0,0,0,0,1,0,4
2607,2,0,0,0,0,0,0,2
2608,2,0,0,0,0,0,0,2
2609,1,0,1,0,0,0,0,2
2610,2,0,0,0,0,0,0,2
2611,2,0,0,0,0,0,0,2
2612,2,0,2,0,0,0,0,4
2613,0,0,0,0,0,1,0,1
2614,3,1,0,0,0,0,0,4
2615,2,0,0,0,0,2,0,4
2616,3,0,0,0,0,0,0,3
2617,1,0,0,0,0,1,0,2
2618,5,0,0,0,0,1,0,6
2619,1,0,0,0,0,0,0,1
2620,4,0,0,0,0,0,0,4
2621,1,0,2,0,0,0,0,3
2622,3,0,0,0,0,1,0,4
2623,1,0,0,0,0,0,0,1
2624,3,0,0,0,0,1,0,4
2625,4,1,0,0,0,1,0,6
2626,1,0,0,0,0,0,0,1
2627,3,0,0,0,0,2,0,5
2628,1,0,0,0,0,1,0,2
2629,5,0,0,0,0,0,0,5
2630,2,1,0,0,0,0,0,3
2631,4,0,0,0,0,0,0,4
2632,4,1,0,0,0,2,0,7
2633,1,0,0,0,0,0,0,1
2634,2,0,0,0,0,0,0,2
2635,2,0,0,0,0,0,0,2
2636,1,0,0,0,0,0,0,1
2637,3,0,0,0,0,0,0,3
2638,3,0,0,0,0,0,0,3
2639,3,0,0,0,0,0,0,3
2640,3,0,0,0,0,3,0,6
2641,1,0,0,0,0,2,0,3
2642,1,0,0,0,0,0,0,1
2643,2,0,0,0,0,0,0,2
2644,1,0,1,0,0,0,0,2
2645,3,0,0,0,0,0,0,3
2646,2,0,0,0,0,1,0,3
2647,2,0,0,0,0,0,0,2
2649,2,0,0,0,0,0,0,2
2650,4,1,0,0,0,0,0,5
2651,1,0,0,0,0,0,0,1
2652,0,0,0,0,0,1,0,1
2653,1,0,0,0,0,0,0,1
2654,4,0,0,0,0,1,0,5
2655,5,0,0,0,0,0,0,5
2657,2,0,0,0,0,1,0,3
2658,1,2,0,0,0,0,0,3
2659,2,0,1,0,0,0,0,3
2660,3,0,0,0,0,0,0,3
2662,2,0,0,0,0,0,0,2
2663,2,0,0,0,0,0,0,2
2664,5,0,0,0,0,0,0,5
2666,3,0,0,0,0,0,0,3
2667,3,0,0,0,0,0,0,3
2668,1,0,0,0,0,1,0,2
2669,4,0,0,0,0,0,0,4
2670,6,0,0,0,0,1,0,7
2671,1,1,0,0,0,0,0,2
2672,2,0,0,0,0,0,0,2
2673,2,0,1,0,0,0,0,3
2674,1,1,0,0,0,0,0,2
2675,1,0,0,0,0,1,0,2
2676,2,0,0,0,0,0,0,2
2677,2,0,0,0,0,0,0,2
2679,4,0,0,0,0,0,0,4
2680,2,0,0,0,0,1,0,3
2681,1,0,0,0,0,0,0,1
2682,1,0,1,0,0,0,0,2
2683,3,0,0,0,0,1,0,4
2684,4,0,1,0,0,1,0,6
2685,3,0,0,0,0,0,0,3
2686,3,0,0,0,0,0,0,3
2687,1,0,0,0,0,0,0,1
2689,2,2,0,0,0,0,0,4
2690,2,0,0,0,0,0,0,2
2691,0,1,0,0,0,0,0,1
2692,1,0,1,1,0,0,0,3
2693,10,0,1,0,0,2,0,13
2694,0,0,0,0,0,1,0,1
2695,0,0,1,0,0,0,0,1
2696,2,0,1,0,0,0,0,3
2697,2,0,0,0,0,0,0,2
2698,5,0,0,0,0,0,0,5
2699,3,0,0,0,0,2,0,5
2700,3,1,0,0,0,1,0,5
2701,2,0,0,0,0,1,0,3
2702,1,1,0,0,0,0,0,2
2703,1,0,0,0,0,0,0,1
2704,2,0,0,0,0,0,0,2
2705,0,0,0,0,0,1,0,1
2707,2,0,0,0,0,0,0,2
2708,4,0,0,0,0,0,0,4
2709,3,3,0,0,0,0,0,6
2710,5,0,0,0,0,0,0,5
2711,5,0,0,0,0,0,0,5
2712,4,0,0,0,0,0,0,4
2713,1,0,0,0,0,0,0,1
2714,2,0,0,0,0,0,0,2
2715,4,0,0,0,0,1,0,5
2716,4,0,0,0,0,0,0,4
2717,2,0,0,0,0,0,0,2
2718,2,0,0,0,0,1,0,3
2719,0,0,0,0,0,1,0,1
2720,5,1,0,0,0,0,0,6
2722,3,0,0,0,0,0,0,3
2723,3,0,0,0,0,0,0,3
2724,1,0,0,0,0,0,0,1
2725,6,0,0,0,0,0,0,6
2726,2,0,0,0,0,0,0,2
2727,2,0,0,0,0,0,0,2
2728,3,0,0,0,0,1,0,4
2729,6,0,0,0,0,0,0,6
2730,2,0,2,0,0,1,0,5
2731,1,0,1,0,0,0,0,2
2732,2,0,0,0,0,0,0,2
2733,0,0,0,0,0,1,0,1
2734,1,0,0,0,0,0,0,1
2735,3,0,0,0,0,0,0,3
2736,2,0,0,0,0,0,0,2
2737,1,0,0,0,0,0,0,1
2738,3,0,1,0,0,1,0,5
2739,0,0,0,0,0,1,0,1
2740,2,0,0,0,0,0,0,2
2741,2,0,0,0,0,0,0,2
2742,2,0,0,0,0,0,0,2
2743,3,1,0,0,0,0,0,4
2745,3,0,0,0,0,0,0,3
2746,5,0,0,0,0,0,0,5
2748,0,0,0,0,0,1,0,1
2749,3,0,0,0,0,1,0,4
2750,5,0,0,0,0,0,0,5
2751,2,0,0,0,0,0,0,2
2752,3,1,0,0,0,0,0,4
2754,6,0,1,0,0,0,0,7
2755,0,0,0,0,0,1,0,1
2756,3,0,0,0,0,0,0,3
2757,5,0,0,0,0,1,0,6
2759,2,0,0,0,0,0,0,2
2760,1,0,0,0,0,0,0,1
2761,2,0,0,0,0,0,0,2
2762,4,0,0,0,0,0,0,4
2763,0,1,0,0,0,0,0,1
2764,3,0,0,0,0,0,0,3
2765,2,0,0,0,0,0,0,2
2766,0,0,0,0,0,1,0,1
2767,2,0,0,0,0,0,0,2
2768,7,0,1,0,0,0,0,8
2769,3,0,0,0,0,0,0,3
2770,3,0,1,0,0,0,0,4
2771,1,0,0,0,0,0,0,1
2772,1,0,0,0,0,0,0,1
2773,0,0,1,0,0,0,0,1
2774,7,1,1,0,0,1,0,10
2775,1,0,0,0,0,0,0,1
2776,3,0,0,0,0,0,0,3
2777,1,0,0,0,0,0,0,1
2779,2,0,0,0,0,0,0,2
2780,4,0,2,0,0,0,0,6
2781,1,0,2,0,0,1,0,4
2783,1,0,1,0,0,1,0,3
2784,2,0,0,0,0,0,0,2
2785,3,0,0,0,0,0,0,3
2786,1,0,0,0,0,1,0,2
2787,2,0,0,0,0,0,0,2
2789,1,0,0,0,0,0,0,1
2790,4,1,0,0,0,0,0,5
2792,4,0,0,0,0,0,0,4
2793,8,0,0,0,0,0,0,8
2795,3,0,0,0,0,1,0,4
2796,1,0,0,0,0,0,0,1
2797,2,0,0,0,0,1,0,3
2798,1,0,1,0,0,0,0,2
2799,4,0,0,0,0,0,0,4
2800,4,0,0,0,0,0,0,4
2801,0,0,0,0,0,1,0,1
2803,1,0,0,0,0,1,0,2
2805,2,0,0,0,0,0,0,2
2806,2,0,0,0,0,0,0,2
2807,1,0,0,0,0,0,0,1
2808,1,0,0,0,0,0,0,1
2809,2,0,1,0,0,0,0,3
2812,4,0,0,0,0,0,0,4
2814,2,0,0,0,0,0,0,2
2815,6,4,1,0,0,1,0,12
2816,5,0,0,0,0,2,0,7
2817,2,0,0,0,0,0,0,2
2818,2,0,0,0,0,0,0,2
2819,1,0,0,0,0,0,0,1
2820,2,0,0,0,0,1,0,3
2821,1,0,1,0,0,1,0,3
2822,1,0,0,0,0,0,0,1
2823,6,0,0,0,0,0,0,6
2824,4,1,0,0,0,0,0,5
2825,2,0,0,0,0,0,0,2
2826,1,0,0,0,0,0,0,1
2827,1,0,0,0,0,1,0,2
2828,2,0,0,0,0,0,0,2
2829,0,0,0,0,0,1,0,1
2830,3,0,0,0,0,1,0,4
2831,2,0,0,0,0,0,0,2
2832,5,0,0,0,0,0,0,5
2833,5,0,0,0,0,0,0,5
2835,2,0,0,0,0,0,0,2
2836,1,0,0,0,0,0,0,1
2837,2,0,0,0,0,0,0,2
2838,2,0,0,0,0,0,0,2
2839,1,0,0,0,0,0,0,1
2840,3,0,0,0,0,0,0,3
2841,1,0,0,0,0,0,0,1
2842,1,0,0,0,0,0,0,1
2843,3,0,1,0,0,0,0,4
2844,2,0,0,0,0,0,0,2
2845,2,0,0,0,0,0,0,2
2846,2,0,0,0,0,0,0,2
2847,1,0,0,0,0,0,0,1
2848,1,0,0,0,0,0,0,1
2849,3,0,0,0,0,1,0,4
2850,2,0,0,0,0,0,0,2
2851,0,0,1,0,0,0,0,1
2852,2,0,0,0,0,1,0,3
2853,1,1,0,0,0,2,0,4
2854,3,0,0,0,0,0,0,3
2855,3,0,0,0,0,0,0,3
2856,6,0,3,0,0,0,0,9
2857,1,0,0,0,0,0,0,1
2858,1,0,0,0,0,0,0,1
2859,3,0,0,0,0,0,0,3
2860,4,0,0,0,0,0,0,4
2861,1,0,0,0,0,0,0,1
2862,1,0,0,0,0,0,0,1
2863,1,0,0,0,0,0,0,1
2864,4,0,0,0,0,0,0,4
2865,0,0,1,0,0,0,0,1
2866,1,0,1,0,0,0,0,2
2868,2,0,0,0,0,0,0,2
2869,2,0,0,0,0,0,0,2
2870,1,0,0,0,0,0,0,1
2871,4,0,0,0,0,0,0,4
2872,2,0,0,0,0,0,0,2
2873,3,0,1,0,0,0,0,4
2874,3,0,0,0,0,0,0,3
2875,1,0,0,0,0,0,0,1
2876,3,0,0,0,0,2,0,5
2877,6,0,0,0,0,2,0,8
2878,4,0,0,0,0,0,0,4
2879,3,1,0,0,0,1,0,5
2880,8,1,0,0,0,0,0,9
2881,3,0,0,0,0,1,0,4
2882,3,0,0,0,0,0,0,3
2883,5,0,0,0,0,0,0,5
2884,1,0,0,0,0,0,0,1
2885,2,0,1,0,0,0,0,3
2886,2,0,0,0,0,0,0,2
2888,3,0,0,0,0,0,0,3
2889,2,0,0,0,0,0,0,2
2890,3,0,0,0,0,0,0,3
2891,2,0,0,0,0,0,0,2
2892,1,0,0,0,0,1,0,2
2893,1,0,0,0,0,0,0,1
2894,2,0,0,0,0,1,0,3
2895,3,0,0,0,0,0,0,3
2896,3,0,0,0,0,2,0,5
2897,1,0,1,0,0,0,0,2
2898,2,0,0,0,0,0,0,2
2899,1,0,0,0,0,0,0,1
2900,1,0,0,0,0,0,0,1
2901,2,0,0,0,0,0,0,2
2902,2,0,1,0,0,1,0,4
2903,1,0,0,1,0,1,0,3
2904,5,0,0,0,0,0,0,5
2905,4,0,0,0,0,1,0,5
2906,4,0,1,0,0,0,0,5
2907,2,0,0,0,0,1,0,3
2908,0,1,1,0,0,0,0,2
2909,3,1,0,0,0,0,0,4
2910,2,0,0,0,0,1,0,3
2911,1,0,0,0,0,0,0,1
2912,2,0,0,0,0,0,0,2
2913,1,0,0,0,0,0,0,1
2914,3,0,0,0,0,0,0,3
2915,6,0,0,0,0,1,0,7
2916,1,0,1,0,0,1,0,3
2917,6,0,0,0,0,0,0,6
2918,4,0,0,0,0,0,0,4
2919,2,0,0,0,0,0,0,2
2920,3,0,0,0,0,0,0,3
2921,2,1,0,0,0,0,0,3
2922,1,0,0,0,0,0,0,1
2923,3,0,0,0,0,2,0,5
2925,2,0,0,0,0,0,0,2
2926,3,0,0,0,0,0,0,3
2927,1,1,0,0,0,0,0,2
2928,3,0,0,0,0,0,0,3
2930,3,0,0,0,0,0,0,3
2931,2,0,0,0,0,1,0,3
2932,1,1,0,0,0,0,0,2
2933,2,0,0,0,0,0,0,2
2935,3,0,1,0,0,0,0,4
2936,1,0,0,0,0,0,0,1
2938,6,1,2,0,0,1,0,10
2939,5,0,0,0,0,0,0,5
2940,2,0,0,0,0,0,0,2
2941,0,1,0,0,0,0,0,1
2942,2,0,0,0,0,0,0,2
2943,1,0,0,0,0,1,0,2
2944,1,0,0,0,0,0,0,1
2945,1,0,0,0,0,0,0,1
2947,1,0,0,0,0,0,0,1
2948,1,0,0,0,0,0,0,1
2949,1,0,0,0,0,1,0,2
2950,1,0,0,0,0,0,0,1
2951,3,0,0,0,0,1,0,4
2952,3,0,1,0,0,1,0,5
2953,2,0,0,0,0,0,0,2
2954,2,0,0,0,0,0,0,2
2955,2,0,0,0,0,1,0,3
2956,1,0,0,0,0,0,0,1
2957,0,1,2,0,0,0,0,3
2958,2,0,1,0,0,0,0,3
2959,1,0,0,0,0,0,0,1
2960,3,0,0,0,0,0,0,3
2961,2,0,1,0,0,0,0,3
2962,2,0,0,0,0,0,0,2
2963,3,0,1,0,0,0,0,4
2964,3,0,0,0,0,0,0,3
2965,1,0,0,0,0,1,0,2
2966,0,0,1,0,0,1,0,2
2967,2,0,0,0,0,0,0,2
2968,2,0,0,0,0,2,0,4
2969,2,0,0,0,0,0,0,2
2970,3,0,0,0,0,0,0,3
2971,2,0,0,0,0,0,0,2
2972,3,1,0,0,0,1,0,5
2973,1,0,0,0,0,1,0,2
2974,1,0,1,0,0,0,0,2
2977,2,0,0,0,0,0,0,2
2978,0,0,0,0,0,1,0,1
2979,1,0,0,0,0,0,0,1
2980,1,1,1,0,0,0,0,3
2981,1,0,0,0,0,0,0,1
2982,2,0,0,0,0,1,0,3
2983,2,0,0,0,0,1,0,3
2984,2,0,0,0,0,0,0,2
2985,2,0,0,0,0,0,0,2
2986,2,0,0,0,0,0,0,2
2987,1,0,0,0,0,0,0,1
2988,0,0,1,0,0,0,0,1
2989,1,0,0,0,0,0,0,1
2990,1,0,0,0,0,0,0,1
2991,2,1,0,0,0,0,0,3
2992,1,0,0,0,0,0,0,1
2993,1,0,0,0,0,0,0,1
2994,1,0,0,0,0,1,0,2
2995,1,1,0,0,0,0,0,2
2996,3,0,0,0,0,0,0,3
2997,1,0,0,0,0,0,0,1
2998,3,0,0,0,0,0,0,3
2999,2,0,0,0,0,0,0,2
3000,4,1,0,0,0,1,0,6
3001,3,0,1,0,0,0,0,4
3002,2,0,0,0,0,0,0,2
3003,1,0,1,0,0,1,0,3
3004,1,0,0,0,0,0,0,1
3005,1,0,0,0,0,0,0,1
3007,2,0,0,0,0,1,0,3
3009,2,0,0,0,0,0,0,2
3010,1,0,0,0,0,0,0,1
3011,2,0,0,0,0,0,0,2
3012,2,0,1,0,0,0,0,3
3013,3,2,1,0,0,0,0,6
3014,1,0,0,0,0,0,0,1
3015,3,0,0,0,0,0,0,3
3016,1,0,0,0,0,0,0,1
3019,5,1,2,0,0,0,0,8
3020,1,0,0,0,0,0,0,1
3021,0,0,1,0,0,0,0,1
3022,2,0,1,0,0,0,0,3
3023,1,0,0,0,0,0,0,1
3024,1,0,0,0,0,0,0,1
3025,3,0,0,0,0,0,0,3
3026,3,1,0,0,0,0,0,4
3027,1,0,0,0,0,1,0,2
3028,1,0,1,0,0,0,0,2
3029,3,0,0,0,0,0,0,3
3030,1,0,0,0,0,2,0,3
3031,1,0,1,0,0,0,0,2
3032,2,0,0,0,0,1,0,3
3033,2,0,0,0,0,0,0,2
3034,1,0,0,0,0,0,0,1
3035,1,0,0,0,0,0,0,1
3036,2,0,0,0,0,0,0,2
3037,3,0,0,0,0,0,0,3
3038,4,0,0,0,0,0,0,4
3039,2,0,0,0,0,0,0,2
3040,0,0,1,0,0,0,0,1
3042,1,0,0,0,0,1,0,2
3043,1,0,0,0,0,0,0,1
3044,1,0,0,0,0,0,0,1
3045,3,0,0,0,0,0,0,3
3046,1,0,1,0,0,1,0,3
3048,2,0,0,0,0,0,0,2
3049,0,0,0,0,0,1,0,1
3050,2,0,1,0,0,1,0,4
3051,3,1,0,0,0,0,0,4
3052,3,0,0,0,0,1,0,4
3053,2,0,1,0,0,1,0,4
3054,2,0,0,0,0,0,0,2
3055,1,0,0,0,0,0,0,1
3056,2,0,0,0,0,0,0,2
3057,1,0,0,0,0,0,0,1
3058,2,0,0,0,0,0,0,2
3059,3,0,1,0,0,0,0,4
3060,8,3,1,0,0,1,0,13
3061,3,0,0,0,0,1,0,4
3062,1,0,0,0,0,0,0,1
3063,4,0,0,0,0,0,0,4
3064,0,1,0,0,0,0,0,1
3066,1,0,0,0,0,1,0,2
3067,2,0,0,0,0,0,0,2
3068,2,1,0,0,0,0,0,3
3069,6,0,0,0,0,0,0,6
3070,2,0,0,0,0,0,0,2
3071,2,0,1,0,0,0,0,3
3073,1,0,0,0,0,0,0,1
3074,2,0,0,0,0,2,0,4
3075,1,0,1,0,0,0,0,2
3076,2,0,0,0,0,0,0,2
3077,0,0,0,0,0,1,0,1
3078,4,0,0,0,0,0,0,4
3079,2,0,1,0,0,0,0,3
3080,1,0,0,0,0,0,0,1
3081,1,0,0,0,0,0,0,1
3082,2,0,0,0,0,0,0,2
3083,3,0,0,0,0,0,0,3
3084,4,0,0,0,0,0,0,4
3085,3,0,0,0,0,0,0,3
3086,2,0,0,0,0,0,0,2
3087,1,0,1,0,0,1,0,3
3088,3,0,0,0,0,0,0,3
3089,1,0,0,0,0,0,0,1
3090,4,0,0,0,0,0,0,4
3091,1,1,0,0,0,2,0,4
3092,1,1,0,0,0,0,0,2
3093,2,0,0,0,0,0,0,2
3094,3,0,0,0,0,0,0,3
3095,1,0,0,0,0,1,0,2
3097,1,0,0,0,0,0,0,1
3098,1,0,0,0,0,0,0,1
3099,2,0,0,0,0,0,0,2
3100,1,0,0,0,0,1,0,2
3101,5,0,1,1,0,0,0,7
3102,1,0,0,0,0,0,0,1
3103,1,0,0,0,0,0,0,1
3104,1,0,1,0,0,0,0,2
3105,2,0,1,0,0,2,0,5
3106,1,1,0,0,0,0,0,2
3107,2,0,1,0,0,0,0,3
3108,1,0,0,0,0,0,0,1
3110,2,0,1,0,0,0,0,3
3111,1,0,0,0,0,0,0,1
3112,1,0,0,0,0,0,0,1
3113,1,0,0,0,0,0,0,1
3114,3,0,0,0,0,0,0,3
3115,2,0,0,0,0,0,0,2
3116,1,0,0,0,0,0,0,1
3117,2,0,0,0,0,0,0,2
3118,1,0,0,0,0,0,0,1
3119,3,0,0,0,0,0,0,3
3120,3,1,1,0,0,0,0,5
3121,4,0,0,0,0,0,0,4
3122,0,0,0,0,0,2,0,2
3123,2,0,0,0,0,0,0,2
3124,2,1,1,0,0,0,0,4
3125,4,0,1,0,0,0,0,5
3126,1,0,0,0,0,0,0,1
3127,4,0,0,0,0,0,0,4
3128,1,0,0,0,0,0,0,1
3129,1,0,0,0,0,0,0,1
3130,2,0,0,0,0,0,0,2
3131,1,0,1,0,0,0,0,2
3132,2,0,0,0,0,0,0,2
3133,2,0,0,0,0,1,0,3
3134,2,0,0,0,0,0,0,2
3135,1,0,0,0,0,0,0,1
3136,2,0,0,0,0,0,0,2
3137,3,0,0,0,0,1,0,4
3140,2,0,0,0,0,0,0,2
3141,2,0,0,0,0,0,0,2
3142,2,0,0,0,0,0,0,2
3143,1,0,0,0,0,0,0,1
3145,3,0,0,0,0,0,0,3
3146,4,0,0,0,0,0,0,4
3147,1,0,0,0,0,0,0,1
3148,2,0,0,0,0,0,0,2
3149,2,0,0,0,0,1,0,3
3150,6,0,0,0,0,3,0,9
3151,1,0,0,0,0,0,0,1
3152,0,1,0,0,0,0,0,1
3153,2,0,0,0,0,0,0,2
3154,2,0,0,0,0,0,0,2
3155,2,0,0,0,0,1,0,3
3156,5,1,0,0,0,0,0,6
3157,3,0,0,0,0,0,0,3
3158,2,0,0,0,0,0,0,2
3159,2,0,0,0,0,0,0,2
3160,1,1,1,0,0,0,0,3
3162,4,0,0,0,0,0,0,4
3164,1,0,0,0,0,0,0,1
3165,1,0,0,0,0,0,0,1
3166,1,0,0,0,0,1,0,2
3168,2,0,0,0,0,0,0,2
3169,1,0,0,0,0,0,0,1
3170,0,1,1,0,0,1,0,3
3171,1,0,0,0,0,0,0,1
3172,2,0,1,0,0,0,0,3
3173,2,0,0,0,0,0,0,2
3174,1,0,0,0,0,0,0,1
3175,2,0,0,0,0,0,0,2
3176,1,0,0,0,0,0,0,1
3177,2,0,0,0,0,0,0,2
3178,4,0,0,0,0,0,0,4
3179,2,0,0,0,0,1,0,3
3180,3,0,0,0,0,0,0,3
3181,1,0,0,0,0,0,0,1
3182,4,1,1,1,0,2,0,9
3183,2,0,0,0,0,1,0,3
3184,1,0,0,0,0,0,0,1
3185,3,0,0,0,0,0,0,3
3186,1,0,0,0,0,0,0,1
3187,1,0,0,0,0,0,0,1
3188,5,0,0,0,0,0,0,5
3190,3,0,0,0,0,0,0,3
3191,2,0,0,0,0,0,0,2
3192,1,0,0,0,0,0,0,1
3193,1,0,0,0,0,1,0,2
3194,1,0,0,0,0,0,0,1
3195,1,0,0,0,0,0,0,1
3196,1,0,0,0,0,1,0,2
3197,4,0,0,0,0,0,0,4
3198,1,0,1,0,0,0,0,2
3199,2,0,1,0,0,0,0,3
3200,5,0,0,0,0,0,0,5
3201,2,0,0,0,0,1,0,3
3202,0,0,0,0,0,1,0,1
3203,1,0,0,0,0,0,0,1
3204,1,0,0,0,0,0,0,1
3205,1,0,0,0,0,0,0,1
3206,2,0,0,0,0,0,0,2
3207,2,0,0,0,0,0,0,2
3208,1,0,0,0,0,0,0,1
3209,5,0,1,0,0,0,0,6
3210,5,0,0,0,0,1,0,6
3211,2,0,1,0,0,0,0,3
3212,1,0,0,0,0,0,0,1
3213,1,0,0,0,0,0,0,1
3214,3,0,0,0,0,1,0,4
3215,1,0,0,0,0,0,0,1
3216,1,0,0,0,0,0,0,1
3218,2,0,0,0,0,0,0,2
3219,1,1,0,0,0,0,0,2
3220,1,0,0,0,0,0,0,1
3221,1,0,0,0,0,0,0,1
3222,1,0,0,0,0,0,0,1
3223,2,0,0,0,0,0,0,2
3224,2,0,1,0,0,0,0,3
3225,3,0,1,0,0,0,0,4
3227,1,0,0,0,0,0,0,1
3228,2,0,0,0,0,0,0,2
3229,2,0,0,0,0,0,0,2
3230,2,0,0,0,0,0,0,2
3232,1,0,0,0,0,1,0,2
3234,2,0,1,0,0,0,0,3
3236,5,0,0,0,0,0,0,5
3237,0,0,1,0,0,0,0,1
3238,2,0,0,0,0,0,0,2
3239,2,0,1,0,0,0,0,3
3241,1,0,0,0,0,0,0,1
3242,2,0,0,0,0,0,0,2
3243,0,1,0,0,0,0,0,1
3244,2,0,0,0,0,0,0,2
3245,1,0,0,0,0,0,0,1
3246,2,0,0,0,0,0,0,2
3247,0,0,1,0,0,0,0,1
3248,1,0,0,0,0,0,0,1
3249,2,0,0,0,0,0,0,2
3250,1,0,0,0,0,0,0,1
3251,2,0,0,0,0,0,0,2
3252,0,0,0,0,0,2,0,2
3254,1,0,0,0,0,1,0,2
3256,3,0,0,0,0,1,0,4
3257,1,0,0,0,0,0,0,1
3260,4,0,0,0,0,0,0,4
3261,4,0,0,0,0,0,0,4
3262,1,0,0,0,0,1,0,2
3264,5,1,1,0,0,0,0,7
3265,1,0,1,0,0,0,0,2
3267,3,0,0,0,0,0,0,3
3268,3,0,0,0,0,0,0,3
3269,0,0,1,0,0,0,0,1
3270,0,0,0,0,0,3,0,3
3271,2,1,0,0,0,0,0,3
3272,2,0,0,0,0,0,0,2
3273,2,0,0,0,0,0,0,2
3274,3,0,0,0,0,1,0,4
3275,2,0,0,0,0,0,0,2
3277,1,0,0,0,0,1,0,2
3278,2,0,0,0,0,0,0,2
3279,4,0,0,0,0,0,0,4
3280,0,1,0,0,0,0,0,1
3281,2,0,0,0,0,0,0,2
3282,1,0,0,0,0,0,0,1
3284,1,0,1,0,0,0,0,2
3286,3,0,0,0,0,0,0,3
3288,0,0,0,0,0,1,0,1
3290,1,0,0,0,0,0,0,1
3291,2,0,0,0,0,0,0,2
3292,1,0,0,0,0,0,0,1
3293,1,0,0,0,0,0,0,1
3295,4,0,0,0,0,0,0,4
3296,2,0,0,0,0,0,0,2
3297,2,0,0,0,0,0,0,2
3298,1,0,0,0,0,0,0,1
3299,1,0,0,0,0,0,0,1
3301,2,0,0,0,0,0,0,2
3302,1,0,0,0,0,0,0,1
3303,4,0,0,0,0,0,0,4
3304,1,1,0,0,0,0,0,2
3305,3,0,1,0,0,0,0,4
3307,1,0,0,0,0,0,0,1
3308,1,0,0,0,0,0,0,1
3309,1,0,0,0,0,0,0,1
3310,4,0,0,0,0,0,0,4
3312,3,0,0,0,0,0,0,3
3313,1,0,0,0,0,0,0,1
3315,4,0,0,0,0,0,0,4
3317,2,0,0,0,0,0,0,2
3318,3,0,0,0,0,0,0,3
3319,1,0,0,0,0,0,0,1
3321,1,0,0,0,0,0,0,1
3322,2,0,0,0,0,0,0,2
3323,1,0,1,0,0,0,0,2
3324,4,0,0,0,0,0,0,4
3325,2,0,0,0,0,0,0,2
3327,2,0,0,0,0,0,0,2
3328,1,0,0,0,0,0,0,1
3329,1,0,0,0,0,0,0,1
3331,2,0,0,0,0,0,0,2
3332,3,0,0,0,0,1,0,4
3333,1,0,0,0,0,0,0,1
3335,1,0,0,0,0,0,0,1
3336,1,0,0,0,0,1,0,2
3337,2,0,0,0,0,0,0,2
3338,2,0,0,0,0,0,0,2
3339,2,0,0,0,0,0,0,2
3340,2,0,0,0,0,0,0,2
3341,1,0,0,0,0,0,0,1
3342,1,0,0,0,0,0,0,1
3343,1,0,0,0,0,0,0,1
3344,2,0,1,0,0,1,0,4
3346,4,0,0,0,0,0,0,4
3347,4,0,0,0,0,0,0,4
3348,2,0,0,0,0,0,0,2
3350,3,0,0,0,0,0,0,3
3351,2,0,0,0,0,0,0,2
3352,1,0,0,0,0,0,0,1
3353,0,1,0,0,0,0,0,1
3354,1,0,0,0,0,1,0,2
3355,3,0,0,0,0,0,0,3
3357,2,0,0,0,0,0,0,2
3359,1,0,0,0,0,0,0,1
3360,5,0,0,0,0,1,0,6
3361,2,0,1,0,0,0,0,3
3363,3,0,0,0,0,0,0,3
3364,2,0,0,0,0,0,0,2
3365,3,0,0,0,0,0,0,3
3366,4,0,1,0,0,1,0,6
3367,2,0,0,0,0,0,0,2
3368,1,0,0,0,0,1,0,2
3370,1,0,0,0,0,0,0,1
3371,1,1,0,0,0,0,0,2
3372,1,0,0,0,0,0,0,1
3373,1,0,1,0,0,0,0,2
3374,3,0,0,0,0,0,0,3
3375,1,0,0,0,0,0,0,1
3376,1,0,0,0,0,0,0,1
3377,1,0,0,0,0,0,0,1
3378,3,0,0,0,0,0,0,3
3379,1,0,0,0,0,1,0,2
3380,1,0,0,0,0,1,0,2
3381,1,0,0,0,0,0,0,1
3382,2,0,0,0,0,0,0,2
3383,1,1,0,0,0,0,0,2
3385,2,0,0,0,0,0,0,2
3386,2,0,0,0,0,0,0,2
3387,1,0,0,0,0,0,0,1
3388,0,0,0,0,0,1,0,1
3389,1,0,0,0,0,0,0,1
3390,2,0,0,0,0,0,0,2
3391,1,0,0,0,0,0,0,1
3394,1,0,0,0,0,1,0,2
3396,5,0,0,0,0,0,0,5
3397,1,0,0,0,0,0,0,1
3400,1,0,0,0,0,0,0,1
3403,1,0,0,0,0,0,0,1
3405,1,0,0,0,0,0,0,1
3407,1,0,0,0,0,0,0,1
3408,0,1,0,0,0,1,0,2
3409,1,2,0,0,0,0,0,3
3410,1,1,0,0,0,0,0,2
3411,2,0,0,0,0,0,0,2
3412,1,0,0,0,0,0,0,1
3413,4,1,0,0,0,0,0,5
3415,1,0,0,0,0,1,0,2
3416,1,0,0,0,0,0,0,1
3417,2,0,0,0,0,0,0,2
3418,1,0,0,0,0,0,0,1
3419,2,0,0,0,0,1,0,3
3420,4,0,0,0,0,0,0,4
3421,1,0,0,0,0,0,0,1
3422,2,0,0,0,0,1,0,3
3423,1,0,0,0,0,0,0,1
3424,1,0,0,0,0,0,0,1
3425,1,0,0,0,0,0,0,1
3427,7,1,2,1,0,0,0,11
3428,1,0,0,0,0,0,0,1
3429,1,0,0,0,0,0,0,1
3430,1,0,0,0,0,0,0,1
3431,2,1,0,0,0,1,0,4
3432,2,0,0,0,0,0,0,2
3433,1,0,0,0,0,0,0,1
3434,0,1,0,0,0,0,0,1
3436,1,0,0,0,0,0,0,1
3437,1,0,0,0,0,0,0,1
3438,1,0,0,0,0,0,0,1
3439,2,0,0,0,0,0,0,2
3440,3,0,0,0,0,0,0,3
3442,1,0,0,0,0,0,0,1
3444,0,1,0,0,0,0,0,1
3445,1,0,0,0,0,1,0,2
3446,4,0,0,0,0,0,0,4
3449,2,0,0,0,0,0,0,2
3450,2,0,0,0,0,0,0,2
3451,1,0,0,0,0,0,0,1
3453,2,0,0,0,0,0,0,2
3454,2,0,0,0,0,0,0,2
3455,0,0,0,0,0,1,0,1
3456,3,0,1,0,0,0,0,4
3457,3,0,0,0,0,0,0,3
3458,1,0,0,0,0,0,0,1
3459,1,0,0,0,0,0,0,1
3460,2,0,0,0,0,0,0,2
3461,1,0,0,0,0,1,0,2
3462,1,0,0,0,0,1,0,2
3463,2,0,0,0,0,0,0,2
3464,1,0,0,0,0,1,0,2
3465,2,0,0,0,0,0,0,2
3467,0,0,1,0,0,1,0,2
3468,5,0,0,0,0,0,0,5
3469,1,0,0,0,0,0,0,1
3470,3,0,0,0,0,0,0,3
3471,1,0,0,0,0,0,0,1
3472,1,0,0,0,0,0,0,1
3473,1,0,0,0,0,0,0,1
3474,2,0,0,0,0,1,0,3
3476,0,0,0,0,0,1,0,1
3477,0,0,1,0,0,0,0,1
3478,2,0,0,0,0,0,0,2
3479,1,0,0,0,0,0,0,1
3480,2,0,0,0,0,0,0,2
3481,4,0,0,0,0,0,0,4
3482,2,0,0,0,0,0,0,2
3483,2,0,0,0,0,0,0,2
3485,2,0,1,0,0,1,0,4
3486,2,0,0,0,0,0,0,2
3487,0,0,1,0,0,0,0,1
3488,3,0,1,0,0,0,0,4
3489,2,0,0,0,0,0,0,2
3491,1,0,0,0,0,0,0,1
3492,2,0,0,0,0,0,0,2
3493,1,0,0,0,0,0,0,1
3494,1,0,0,0,0,0,0,1
3495,1,0,0,0,0,0,0,1
3496,3,0,1,0,0,0,0,4
3498,1,1,0,0,0,0,0,2
3499,1,0,0,0,0,0,0,1
3500,4,1,4,2,0,0,0,11
3502,2,0,1,0,0,0,0,3
3504,1,0,1,0,0,0,0,2
3505,5,0,0,0,0,0,0,5
3506,2,0,0,0,0,0,0,2
3507,1,0,0,0,0,0,0,1
3508,0,0,1,0,0,0,0,1
3509,4,0,0,0,0,0,0,4
3510,4,0,0,0,0,0,0,4
3511,1,0,0,0,0,0,0,1
3513,1,0,0,0,0,2,0,3
3514,2,0,0,0,0,0,0,2
3516,2,0,0,0,0,0,0,2
3517,0,0,1,0,0,0,0,1
3518,1,0,0,0,0,0,0,1
3519,3,0,0,0,0,0,0,3
3520,4,0,1,0,0,0,0,5
3521,1,0,0,0,0,0,0,1
3523,3,0,0,0,0,0,0,3
3524,2,0,0,0,0,0,0,2
3526,1,0,1,0,0,0,0,2
3527,0,1,0,0,0,0,0,1
3528,1,0,0,0,0,0,0,1
3529,2,0,0,0,0,0,0,2
3531,1,0,0,0,0,0,0,1
3532,1,0,0,0,0,0,0,1
3533,2,0,0,0,0,0,0,2
3534,2,0,0,0,0,0,0,2
3535,1,0,0,0,0,0,0,1
3536,3,0,0,0,0,1,0,4
3537,0,0,1,0,0,1,0,2
3538,1,0,0,0,0,0,0,1
3539,4,0,0,0,0,0,0,4
3540,2,0,0,0,0,0,0,2
3544,0,0,2,0,0,0,0,2
3545,2,0,0,0,0,0,0,2
3546,3,1,0,0,0,0,0,4
3547,1,0,0,0,0,0,0,1
3548,1,0,0,0,0,0,0,1
3549,1,0,0,0,0,0,0,1
3550,7,0,1,0,0,0,0,8
3551,1,0,0,0,0,0,0,1
3552,1,0,0,0,0,0,0,1
3554,2,0,0,0,0,0,0,2
3557,2,0,0,0,0,0,0,2
3558,3,0,0,0,0,1,0,4
3559,1,0,0,0,0,0,0,1
3560,7,0,0,0,0,0,0,7
3561,1,0,0,0,0,0,0,1
3562,2,1,0,0,0,0,0,3
3563,1,0,0,0,0,1,0,2
3564,1,0,0,0,0,1,0,2
3565,1,0,0,0,0,0,0,1
3566,3,0,0,0,0,0,0,3
3567,2,0,0,0,0,0,0,2
3569,1,0,0,0,0,0,0,1
3570,3,0,0,0,0,0,0,3
3571,1,0,0,0,0,1,0,2
3572,1,0,0,0,0,0,0,1
3573,3,0,0,0,0,0,0,3
3575,3,0,1,0,0,0,0,4
3576,1,0,0,0,0,0,0,1
3577,2,0,0,0,0,0,0,2
3579,2,0,0,0,0,0,0,2
3580,1,0,0,0,0,0,0,1
3581,2,0,0,0,0,0,0,2
3582,4,0,0,0,0,0,0,4
3583,1,0,0,0,0,0,0,1
3585,1,0,1,0,0,1,0,3
3586,4,0,0,0,0,1,0,5
3587,3,0,0,0,0,0,0,3
3589,1,0,0,0,0,0,0,1
3592,1,0,0,0,0,0,0,1
3593,0,0,0,0,0,1,0,1
3594,3,0,0,0,0,0,0,3
3595,1,0,0,0,0,0,0,1
3597,1,0,0,0,0,0,0,1
3598,1,0,0,0,0,0,0,1
3599,1,0,0,0,0,0,0,1
3600,5,0,1,0,0,2,0,8
3601,1,0,0,0,0,0,0,1
3602,2,0,0,0,0,0,0,2
3603,0,0,0,0,0,1,0,1
3604,1,0,0,0,0,1,0,2
3605,1,0,0,0,0,0,0,1
3606,1,0,0,0,0,0,0,1
3607,1,0,0,0,0,0,0,1
3608,2,0,0,0,0,0,0,2
3609,1,0,0,0,0,0,0,1
3610,2,0,0,0,0,0,0,2
3611,4,1,0,0,0,0,0,5
3612,0,0,0,0,0,1,0,1
3613,3,0,0,0,0,0,0,3
3614,4,0,0,0,0,0,0,4
3615,2,0,0,0,0,0,0,2
3616,1,0,0,0,0,0,0,1
3618,3,0,0,0,0,0,0,3
3619,1,0,0,0,0,0,0,1
3620,1,0,0,0,0,0,0,1
3623,1,0,0,0,0,0,0,1
3624,2,0,0,0,0,0,0,2
3625,1,0,0,0,0,0,0,1
3628,2,0,0,0,0,0,0,2
3629,1,0,0,0,0,0,0,1
3631,4,0,0,0,0,0,0,4
3633,1,0,0,0,0,0,0,1
3634,1,0,0,0,0,1,0,2
3635,1,0,0,0,0,0,0,1
3636,2,0,0,0,0,0,0,2
3637,2,0,0,0,0,0,0,2
3638,1,1,0,0,0,0,0,2
3640,2,1,0,0,0,0,0,3
3641,0,1,0,0,0,0,0,1
3642,1,0,0,0,0,0,0,1
3647,2,0,0,0,0,0,0,2
3648,1,0,0,0,0,0,0,1
3649,1,0,0,0,0,0,0,1
3650,5,0,0,0,0,0,0,5
3651,3,1,0,0,0,0,0,4
3652,0,1,0,0,0,0,0,1
3653,2,0,0,0,0,1,0,3
3654,3,0,0,0,0,0,0,3
3655,3,0,0,0,0,0,0,3
3657,2,0,0,0,0,0,0,2
3658,1,0,0,0,0,0,0,1
3659,3,0,0,0,0,0,0,3
3660,1,0,0,0,0,0,0,1
3661,1,0,0,0,0,0,0,1
3662,1,0,0,0,0,0,0,1
3663,0,0,0,0,0,1,0,1
3664,0,0,1,0,0,0,0,1
3665,1,1,0,0,0,0,0,2
3666,1,0,0,0,0,0,0,1
3667,0,0,0,0,0,2,0,2
3668,2,0,0,0,0,0,0,2
3669,1,0,0,0,0,1,0,2
3671,1,0,0,0,0,0,0,1
3672,1,1,1,0,0,1,0,4
3674,4,0,0,0,0,0,0,4
3675,2,0,0,0,0,0,0,2
3676,1,0,0,0,0,0,0,1
3678,2,0,0,0,0,1,0,3
3680,2,0,0,0,0,0,0,2
3681,1,0,0,0,0,0,0,1
3683,0,0,0,0,0,1,0,1
3684,2,0,0,0,0,0,0,2
3685,1,1,0,0,0,0,0,2
3686,1,0,0,0,0,1,0,2
3689,3,0,0,0,0,0,0,3
3690,0,1,0,0,0,0,0,1
3691,1,0,0,0,0,1,0,2
3692,3,0,0,0,0,0,0,3
3693,0,1,0,0,0,0,0,1
3694,1,0,0,0,0,0,0,1
3695,1,0,0,0,0,1,0,2
3696,0,0,0,0,0,1,0,1
3697,1,0,0,0,0,0,0,1
3699,1,0,0,0,0,0,0,1
3700,2,0,0,0,0,0,0,2
3701,1,0,1,0,0,0,0,2
3702,2,0,0,0,0,0,0,2
3703,2,0,0,0,0,0,0,2
3704,2,0,0,0,0,0,0,2
3705,2,0,0,0,0,0,0,2
3706,1,0,0,0,0,0,0,1
3707,0,0,0,0,0,1,0,1
3709,1,1,0,0,0,0,0,2
3710,2,0,1,0,0,0,0,3
3711,1,0,1,0,0,1,0,3
3712,5,0,0,0,0,0,0,5
3713,1,0,0,0,0,0,0,1
3714,0,0,0,0,0,1,0,1
3715,2,0,0,0,0,0,0,2
3716,3,0,0,0,0,0,0,3
3718,1,0,0,0,0,0,0,1
3719,1,0,0,0,0,0,0,1
3721,1,0,0,0,0,0,0,1
3725,1,0,0,0,0,0,0,1
3726,3,0,0,0,0,1,0,4
3727,1,0,0,0,0,0,0,1
3728,2,0,0,0,0,0,0,2
3729,1,0,0,0,0,0,0,1
3730,3,0,0,0,0,0,0,3
3731,1,0,0,0,0,0,0,1
3733,1,0,0,0,0,0,0,1
3735,1,0,0,0,0,0,0,1
3737,0,0,1,0,0,0,0,1
3738,1,0,0,0,0,0,0,1
3739,1,0,0,0,0,0,0,1
3740,4,0,0,0,0,0,0,4
3741,1,0,0,0,0,0,0,1
3742,3,0,0,0,0,0,0,3
3743,1,0,0,0,0,1,0,2
3744,1,1,0,0,0,0,0,2
3745,1,0,0,0,0,0,0,1
3746,1,0,0,0,0,0,0,1
3748,3,0,0,0,0,0,0,3
3749,0,1,0,0,0,0,0,1
3751,1,0,0,0,0,0,0,1
3754,2,0,0,0,0,0,0,2
3755,0,0,1,0,0,0,0,1
3756,3,0,0,0,0,1,0,4
3757,2,1,0,0,0,1,0,4
3758,2,0,0,0,0,0,0,2
3759,1,0,0,0,0,0,0,1
3761,1,0,0,0,0,0,0,1
3763,1,0,0,0,0,0,0,1
3765,1,0,0,0,0,0,0,1
3768,1,0,0,0,0,0,0,1
3770,4,0,0,0,0,0,0,4
3771,3,0,0,0,0,0,0,3
3772,1,0,0,0,0,0,0,1
3773,1,0,0,0,0,0,0,1
3774,0,1,0,0,0,0,0,1
3775,1,0,0,0,0,1,0,2
3777,2,0,0,0,0,0,0,2
3778,1,0,1,0,0,0,0,2
3779,2,0,0,0,0,0,0,2
3780,0,0,0,0,0,1,0,1
3781,1,0,0,0,0,0,0,1
3782,1,0,0,0,0,0,0,1
3783,1,0,1,0,0,0,0,2
3786,1,0,0,0,0,0,0,1
3788,1,1,0,0,0,0,0,2
3789,1,0,0,0,0,0,0,1
3790,1,0,0,0,0,0,0,1
3791,1,0,0,0,0,0,0,1
3792,1,0,0,0,0,0,0,1
3793,1,0,0,1,0,0,0,2
3794,6,0,3,0,0,0,0,9
3795,2,0,0,0,0,0,0,2
3796,1,0,1,0,0,0,0,2
3797,1,0,1,0,0,0,0,2
3798,2,0,0,0,0,0,0,2
3799,1,0,0,0,0,0,0,1
3800,0,1,0,0,0,0,0,1
3801,0,0,0,0,0,1,0,1
3803,1,0,1,0,0,0,0,2
3804,1,0,0,0,0,0,0,1
3806,1,0,0,0,0,0,0,1
3807,0,0,1,0,0,0,0,1
3808,1,0,0,0,0,0,0,1
3809,1,0,0,0,0,0,0,1
3810,3,0,0,0,0,0,0,3
3811,2,0,0,0,0,1,0,3
3812,3,1,0,0,0,0,0,4
3813,1,0,0,0,0,1,0,2
3814,1,0,0,0,0,1,0,2
3818,2,0,0,0,0,0,0,2
3819,2,0,0,0,0,0,0,2
3821,1,0,0,0,0,0,0,1
3823,1,0,1,0,0,0,0,2
3824,1,0,0,0,0,0,0,1
3825,2,0,0,0,0,0,0,2
3826,1,0,0,0,0,0,0,1
3829,2,0,0,0,0,0,0,2
3830,0,1,0,0,0,0,0,1
3831,1,0,0,0,0,1,0,2
3832,1,0,0,0,0,0,0,1
3833,2,0,0,0,0,0,0,2
3834,0,1,0,0,0,0,0,1
3835,1,0,0,0,0,0,0,1
3836,1,0,0,0,0,1,0,2
3838,1,0,0,0,0,0,0,1
3839,1,0,0,0,0,0,0,1
3840,1,1,2,0,0,0,0,4
3841,1,0,0,0,0,0,0,1
3842,3,0,0,0,0,0,0,3
3843,1,0,0,0,0,1,0,2
3844,1,0,0,0,0,0,0,1
3845,1,0,0,0,0,0,0,1
3846,1,0,0,0,0,0,0,1
3847,1,0,0,0,0,0,0,1
3850,0,0,2,0,0,0,0,2
3851,3,0,0,0,0,0,0,3
3852,1,0,0,0,0,1,0,2
3853,2,0,0,0,0,0,0,2
3855,1,0,0,0,0,0,0,1
3856,2,1,0,0,0,0,0,3
3857,2,0,0,0,0,0,0,2
3859,2,0,0,0,0,0,0,2
3860,2,0,0,0,0,0,0,2
3861,1,0,0,0,0,0,0,1
3862,2,0,0,0,0,1,0,3
3863,1,0,1,0,0,0,0,2
3865,1,0,0,0,0,0,0,1
3866,1,0,1,0,0,0,0,2
3867,1,0,1,0,0,0,0,2
3868,1,0,0,0,0,0,0,1
3870,1,0,0,0,0,0,0,1
3871,1,0,0,0,0,0,0,1
3873,2,0,0,0,0,0,0,2
3875,4,0,0,0,0,0,0,4
3876,1,1,0,0,0,0,0,2
3877,1,0,0,0,0,0,0,1
3878,1,0,0,0,0,0,0,1
3879,1,1,0,0,0,0,0,2
3882,2,0,0,0,0,0,0,2
3884,4,0,0,0,0,0,0,4
3886,1,0,0,0,0,0,0,1
3887,2,0,0,0,0,0,0,2
3893,1,0,0,0,0,0,0,1
3894,1,0,0,0,0,0,0,1
3895,2,0,0,0,0,0,0,2
3896,1,0,0,0,0,0,0,1
3899,1,0,0,0,0,0,0,1
3900,2,0,0,0,0,0,0,2
3901,3,0,0,0,0,0,0,3
3902,1,0,0,0,0,0,0,1
3905,0,0,0,0,0,1,0,1
3906,2,0,0,0,0,0,0,2
3908,1,0,0,0,0,0,0,1
3911,1,0,0,0,0,0,0,1
3913,1,0,0,0,0,0,0,1
3914,2,0,0,0,0,0,0,2
3915,2,0,0,0,0,0,0,2
3916,1,0,0,0,0,0,0,1
3917,5,0,3,0,0,0,0,8
3918,1,0,0,0,0,0,0,1
3919,2,0,0,0,0,0,0,2
3920,3,0,0,0,0,0,0,3
3922,1,0,0,0,0,0,0,1
3923,2,0,0,0,0,0,0,2
3925,1,0,0,0,0,0,0,1
3927,1,0,0,0,0,0,0,1
3928,1,0,0,0,0,0,0,1
3930,1,0,0,0,0,0,0,1
3932,1,0,0,0,0,0,0,1
3933,2,0,0,0,0,0,0,2
3935,1,0,0,0,0,0,0,1
3936,1,0,1,0,0,0,0,2
3937,1,0,0,0,0,0,0,1
3938,1,0,0,0,0,0,0,1
3939,3,1,0,0,0,1,0,5
3943,0,0,1,0,0,0,0,1
3944,1,0,0,0,0,0,0,1
3946,2,0,0,0,0,0,0,2
3947,1,0,0,0,0,0,0,1
3948,1,0,0,0,0,0,0,1
3949,1,0,0,0,0,0,0,1
3950,1,0,0,0,0,0,0,1
3951,0,1,0,0,0,0,0,1
3953,3,0,0,0,0,1,0,4
3954,1,0,0,0,0,0,0,1
3955,1,0,0,0,0,0,0,1
3956,1,0,0,0,0,0,0,1
3957,1,0,0,0,0,0,0,1
3958,1,0,0,0,0,0,0,1
3960,3,1,0,0,0,0,0,4
3962,2,0,0,0,0,0,0,2
3963,0,1,0,0,0,0,0,1
3965,1,0,0,0,0,0,0,1
3967,1,0,0,0,0,0,0,1
3968,4,0,1,0,0,0,0,5
3970,3,0,0,0,0,0,0,3
3971,0,0,1,0,0,0,0,1
3972,2,0,0,0,0,0,0,2
3974,1,0,0,0,0,0,0,1
3977,1,0,0,0,0,0,0,1
3978,6,0,1,0,0,1,0,8
3979,1,0,0,0,0,0,0,1
3980,1,0,0,0,0,1,0,2
3981,1,0,0,0,0,0,0,1
3983,1,0,0,0,0,0,0,1
3984,1,0,0,0,0,0,0,1
3985,1,0,0,0,0,0,0,1
3986,1,0,0,0,0,1,0,2
3987,2,0,0,0,0,1,0,3
3990,1,0,0,0,0,0,0,1
3992,1,0,0,0,0,2,0,3
3996,1,0,0,0,0,0,0,1
3998,3,0,0,0,0,0,0,3
4000,1,0,0,0,0,0,0,1
4001,4,0,0,0,0,0,0,4
4004,1,0,0,0,0,0,0,1
4005,1,0,0,0,0,1,0,2
4006,2,0,0,0,0,0,0,2
4007,3,1,0,0,0,1,0,5
4009,1,0,0,0,0,1,0,2
4014,1,0,1,0,0,0,0,2
4016,1,0,0,0,0,0,0,1
4018,1,0,0,0,0,0,0,1
4019,2,0,0,0,0,0,0,2
4020,5,0,0,0,0,0,0,5
4022,1,0,0,0,0,0,0,1
4023,1,0,0,0,0,0,0,1
4026,1,0,0,0,0,0,0,1
4028,1,0,0,0,0,0,0,1
4029,1,0,0,0,0,0,0,1
4030,1,0,0,0,0,0,0,1
4032,1,0,0,0,0,0,0,1
4033,1,0,0,0,0,0,0,1
4036,2,0,1,0,0,0,0,3
4038,2,0,0,0,0,0,1,3
4039,8,0,1,0,0,0,0,9
4041,1,0,0,0,0,0,0,1
4042,2,0,0,0,0,0,0,2
4044,1,0,0,0,0,0,0,1
4045,1,0,0,0,0,0,0,1
4048,1,0,0,0,0,0,0,1
4049,1,0,0,0,0,0,0,1
4052,1,0,0,0,0,0,0,1
4053,1,1,0,0,0,0,0,2
4054,1,0,0,0,0,0,0,1
4055,1,0,0,0,0,0,0,1
4057,1,0,1,0,0,0,0,2
4058,1,0,0,0,0,0,0,1
4059,1,0,0,0,0,0,0,1
4060,1,0,0,0,0,0,0,1
4061,2,0,0,0,0,0,0,2
4062,2,0,0,0,0,0,0,2
4063,0,0,1,0,0,0,0,1
4065,1,0,0,0,0,0,0,1
4067,1,0,0,0,0,0,0,1
4069,1,0,0,0,0,0,0,1
4072,2,0,0,0,0,0,0,2
4073,2,0,0,0,0,0,0,2
4074,2,0,0,0,0,0,0,2
4076,3,1,0,0,0,1,0,5
4077,1,0,0,0,0,0,0,1
4079,1,0,0,0,0,0,0,1
4080,1,0,0,0,0,0,0,1
4081,2,0,0,0,0,1,0,3
4083,3,1,0,0,0,0,0,4
4084,1,0,0,0,0,0,0,1
4087,1,0,0,0,0,0,0,1
4088,2,1,0,0,0,0,0,3
4089,1,0,0,0,0,0,0,1
4090,0,0,1,0,0,0,0,1
4091,1,0,0,0,0,0,0,1
4092,0,1,0,0,0,0,0,1
4093,1,0,0,0,0,0,0,1
4095,2,0,0,0,0,0,0,2
4097,1,0,0,0,0,0,0,1
4098,1,0,0,0,0,0,0,1
4099,1,0,0,0,0,0,0,1
4100,4,0,1,0,0,0,0,5
4101,1,0,0,0,0,0,0,1
4102,1,0,0,0,0,0,0,1
4103,1,0,0,0,0,0,0,1
4105,3,0,0,0,0,0,0,3
4106,1,0,0,0,0,0,0,1
4107,1,0,0,0,0,0,0,1
4108,3,0,0,0,0,0,0,3
4109,3,0,0,0,0,0,0,3
4110,2,0,0,0,0,1,0,3
4111,2,0,0,0,0,0,0,2
4112,1,0,0,0,0,0,0,1
4113,2,0,0,0,0,0,0,2
4114,0,0,0,0,0,1,0,1
4115,1,0,0,0,0,0,0,1
4116,1,0,0,0,0,0,0,1
4119,1,0,0,0,0,0,0,1
4121,1,0,0,0,0,0,0,1
4126,1,0,0,0,0,0,0,1
4130,2,0,0,0,0,0,0,2
4132,1,1,0,0,0,0,0,2
4133,0,1,0,0,0,0,0,1
4134,1,0,0,0,0,0,0,1
4135,1,0,0,0,0,0,0,1
4137,3,0,0,0,0,0,0,3
4138,1,0,0,0,0,0,0,1
4139,0,0,1,0,0,0,0,1
4140,1,0,1,0,0,1,0,3
4141,2,0,0,0,0,0,0,2
4143,1,0,0,0,0,0,0,1
4144,2,0,0,0,0,0,0,2
4145,0,1,0,0,0,0,0,1
4146,1,0,0,0,0,0,0,1
4147,2,0,0,0,0,0,0,2
4148,1,0,0,0,0,0,0,1
4149,1,0,0,0,0,0,0,1
4150,1,0,0,0,0,0,0,1
4151,2,0,1,0,0,0,0,3
4152,2,0,0,0,0,0,0,2
4154,1,0,0,0,0,0,0,1
4155,2,1,0,0,0,0,0,3
4156,0,0,0,0,0,1,0,1
4157,1,0,0,0,0,0,0,1
4162,4,1,1,0,0,1,0,7
4163,1,0,0,0,0,0,0,1
4165,1,0,0,0,0,0,0,1
4166,2,0,0,0,0,1,0,3
4168,1,0,0,0,0,0,0,1
4169,3,0,1,0,0,0,0,4
4170,1,0,0,0,0,0,0,1
4175,2,0,0,0,0,0,0,2
4176,1,0,0,0,0,0,0,1
4179,1,0,0,0,0,0,0,1
4181,1,0,0,0,0,0,0,1
4184,1,0,0,0,0,0,0,1
4186,1,0,1,0,0,0,0,2
4187,1,0,1,0,0,0,0,2
4190,2,0,1,0,0,0,0,3
4191,1,0,0,0,0,0,0,1
4192,2,0,0,0,0,0,0,2
4193,0,0,1,0,0,0,0,1
4195,1,0,1,0,0,0,0,2
4196,0,1,0,0,0,0,0,1
4197,0,0,1,0,0,0,0,1
4199,1,0,0,0,0,0,0,1
4200,2,0,0,0,0,1,0,3
4201,1,0,0,0,0,0,0,1
4202,1,0,0,0,0,0,0,1
4203,2,0,0,0,0,0,0,2
4204,2,0,0,0,0,0,0,2
4208,1,0,0,0,0,0,0,1
4209,1,0,0,0,0,0,0,1
4210,1,0,1,0,0,0,0,2
4211,1,0,0,0,0,0,0,1
4212,3,0,0,0,0,1,0,4
4214,2,0,0,0,0,0,0,2
4216,1,0,0,0,0,0,0,1
4218,2,0,0,0,0,0,0,2
4219,1,0,0,0,0,0,0,1
4220,1,0,0,0,0,0,0,1
4221,1,0,0,0,0,0,0,1
4222,1,0,0,0,0,0,0,1
4223,0,0,0,1,0,0,0,1
4224,1,0,0,0,0,0,0,1
4225,1,0,1,0,0,0,0,2
4229,1,0,0,0,0,0,0,1
4230,1,0,0,0,0,0,0,1
4231,2,0,1,0,0,0,0,3
4233,4,0,0,0,0,0,0,4
4234,1,0,0,0,0,0,0,1
4235,1,0,0,0,0,0,0,1
4236,1,0,0,0,0,0,0,1
4239,1,0,0,0,0,0,0,1
4240,4,0,0,0,0,0,0,4
4241,2,0,0,0,0,0,0,2
4243,4,0,0,0,0,0,0,4
4244,0,0,1,0,0,0,0,1
4245,2,0,0,0,0,0,0,2
4246,2,0,0,0,0,0,0,2
4247,1,0,0,0,0,0,0,1
4248,1,0,0,0,0,0,0,1
4253,1,0,0,0,0,0,0,1
4254,1,0,0,0,0,0,0,1
4256,1,0,0,0,0,1,0,2
4258,2,0,0,0,0,0,0,2
4261,1,0,0,0,0,0,0,1
4263,2,0,0,0,0,0,0,2
4264,2,0,0,0,0,0,0,2
4265,3,0,0,0,0,0,0,3
4266,3,0,0,0,0,0,0,3
4268,1,0,0,0,0,0,0,1
4269,2,0,1,0,0,0,0,3
4270,1,0,0,0,0,0,0,1
4273,1,0,0,0,0,0,0,1
4276,1,0,0,0,0,0,0,1
4277,2,0,0,0,0,0,0,2
4280,2,0,0,0,0,0,0,2
4283,1,0,0,0,0,0,0,1
4284,5,0,1,0,0,0,0,6
4285,1,0,0,0,0,0,0,1
4286,1,0,0,0,0,0,0,1
4288,1,0,0,0,0,0,0,1
4289,1,0,0,0,0,1,0,2
4295,2,0,0,0,0,0,0,2
4296,1,0,0,0,0,0,0,1
4298,1,0,0,0,0,0,0,1
4299,1,0,0,0,0,0,0,1
4301,2,0,0,0,0,0,0,2
4302,1,0,0,0,0,0,0,1
4304,1,0,0,0,0,0,0,1
4307,0,0,0,0,0,1,0,1
4308,1,0,0,0,0,0,0,1
4310,0,0,0,0,0,1,0,1
4312,1,0,0,0,0,0,0,1
4313,1,0,0,0,0,0,0,1
4314,1,0,1,0,0,0,0,2
4315,1,0,0,0,0,0,0,1
4316,0,0,0,0,0,1,0,1
4317,2,0,0,0,0,0,0,2
4318,1,0,0,0,0,0,0,1
4319,2,0,0,0,0,1,0,3
4320,1,0,0,0,0,1,0,2
4321,1,0,0,0,0,0,0,1
4322,0,0,1,0,0,0,0,1
4323,0,0,0,0,0,1,0,1
4324,2,0,0,0,0,0,0,2
4325,1,0,0,0,0,0,0,1
4326,1,0,0,0,0,0,0,1
4329,1,0,0,0,0,0,0,1
4330,1,0,0,0,0,0,0,1
4332,1,0,0,0,0,0,0,1
4333,0,0,0,0,0,1,0,1
4336,2,0,0,0,0,0,0,2
4337,1,0,0,0,0,0,0,1
4338,1,0,0,0,0,0,0,1
4340,1,0,0,0,0,0,0,1
4341,2,0,0,0,0,0,0,2
4342,1,0,0,0,0,0,0,1
4343,1,0,0,0,0,0,0,1
4344,1,0,0,0,0,0,0,1
4345,1,1,0,0,0,0,0,2
4347,1,0,0,0,0,0,0,1
4348,3,0,0,0,0,0,0,3
4351,1,0,0,0,0,0,0,1
4352,1,0,0,0,0,0,0,1
4353,1,0,1,0,0,0,0,2
4354,1,0,0,0,0,0,0,1
4355,1,0,0,0,0,0,0,1
4357,1,1,0,0,0,0,0,2
4358,3,0,1,0,0,0,0,4
4360,1,0,0,0,0,0,0,1
4363,2,0,0,0,0,0,0,2
4368,1,0,0,0,0,0,0,1
4369,1,0,0,0,0,0,0,1
4370,1,0,0,0,0,0,0,1
4371,2,0,0,0,0,0,0,2
4372,2,0,0,0,0,0,0,2
4374,1,0,0,0,0,0,0,1
4375,1,0,0,0,0,1,0,2
4377,1,0,0,0,0,0,0,1
4379,1,0,0,0,0,0,0,1
4380,2,0,0,0,0,1,0,3
4381,4,0,0,0,0,0,0,4
4383,1,0,0,0,0,0,0,1
4384,2,0,0,0,0,0,0,2
4386,0,0,1,0,0,0,0,1
4387,1,0,0,0,0,0,0,1
4391,2,0,0,0,0,0,0,2
4393,1,0,0,0,0,0,0,1
4394,1,0,0,0,0,0,0,1
4396,4,0,0,0,0,0,0,4
4399,1,0,0,0,0,0,0,1
4400,1,0,0,0,0,0,0,1
4401,0,0,1,0,0,0,0,1
4402,1,0,0,0,0,0,0,1
4403,0,1,0,0,0,0,0,1
4404,0,0,1,0,0,0,0,1
4406,4,0,0,0,0,0,0,4
4410,0,1,0,0,0,0,0,1
4412,1,0,1,0,0,0,0,2
4413,0,0,1,0,0,0,0,1
4414,0,1,0,0,0,0,0,1
4415,1,0,0,0,0,0,0,1
4418,1,2,0,0,0,0,0,3
4419,1,0,0,0,0,0,0,1
4420,4,0,0,0,0,0,0,4
4421,0,0,0,0,0,1,0,1
4422,2,0,0,0,0,0,0,2
4423,1,0,0,0,0,0,0,1
4424,1,0,0,0,0,0,0,1
4425,0,0,1,0,0,0,0,1
4427,1,0,0,0,0,0,0,1
4428,0,1,0,0,0,0,0,1
4430,1,0,0,0,0,0,0,1
4434,0,1,0,0,0,0,0,1
4435,1,0,0,0,0,0,0,1
4440,4,0,0,0,0,0,0,4
4442,1,0,0,0,0,0,0,1
4443,1,0,0,0,0,0,0,1
4444,0,0,1,0,0,0,0,1
4445,3,0,0,0,0,0,0,3
4446,0,0,1,0,0,0,0,1
4448,1,0,1,0,0,1,0,3
4450,1,0,0,0,0,0,0,1
4451,1,0,1,0,0,0,0,2
4452,2,0,0,0,0,0,0,2
4453,2,0,1,0,0,0,0,3
4456,1,0,0,0,0,0,0,1
4460,1,0,0,0,0,0,0,1
4462,2,0,0,0,0,0,0,2
4468,2,0,0,0,0,0,0,2
4469,1,0,0,0,0,0,0,1
4470,2,0,0,0,0,0,0,2
4473,1,0,0,0,0,0,0,1
4474,2,0,0,0,0,0,0,2
4475,1,0,0,0,0,0,0,1
4479,1,0,1,0,0,0,0,2
4480,1,0,0,0,0,0,0,1
4481,1,0,0,0,0,0,0,1
4482,1,0,0,0,0,0,0,1
4484,0,0,0,0,0,1,0,1
4485,2,0,0,0,0,0,0,2
4486,2,0,1,0,0,0,0,3
4487,1,0,1,0,0,0,0,2
4488,2,1,0,0,0,0,0,3
4489,1,0,0,0,0,0,0,1
4492,1,0,0,0,0,0,0,1
4494,1,0,0,0,0,0,0,1
4495,1,0,0,0,0,0,0,1
4496,2,0,0,0,0,0,0,2
4497,1,0,0,0,0,0,0,1
4498,1,0,0,0,0,0,0,1
4501,1,0,0,0,0,0,0,1
4502,0,0,1,0,0,0,0,1
4504,1,0,0,0,0,0,0,1
4505,1,0,0,0,0,0,0,1
4506,1,0,0,0,0,0,0,1
4508,0,0,1,0,0,0,0,1
4509,1,0,0,0,0,0,0,1
4510,1,0,0,0,0,0,0,1
4514,1,0,0,0,0,0,0,1
4515,0,0,0,0,0,1,0,1
4516,1,0,0,0,0,0,0,1
4518,2,0,0,0,0,1,0,3
4521,2,0,0,0,0,0,0,2
4525,1,0,0,0,0,0,0,1
4526,2,0,0,0,0,1,0,3
4529,6,0,0,0,0,1,0,7
4530,1,0,0,0,0,0,0,1
4532,1,0,0,0,0,0,0,1
4533,1,0,0,0,0,0,0,1
4535,1,0,0,0,0,0,0,1
4536,1,0,1,0,0,0,0,2
4537,1,0,0,0,0,0,0,1
4538,1,0,0,0,0,0,0,1
4540,3,0,0,0,0,0,0,3
4543,1,0,0,0,0,0,0,1
4544,1,0,0,0,0,0,0,1
4545,1,0,0,0,0,0,0,1
4546,2,0,0,0,0,0,0,2
4548,2,0,0,0,0,0,0,2
4549,0,0,1,0,0,0,0,1
4552,0,0,1,0,0,0,0,1
4554,1,0,0,0,0,0,0,1
4557,1,0,0,0,0,0,0,1
4558,0,0,1,0,0,0,0,1
4559,2,0,0,0,0,0,0,2
4560,1,0,1,0,0,0,0,2
4561,1,0,0,0,0,0,0,1
4563,1,0,0,0,0,0,0,1
4565,0,1,0,0,0,0,0,1
4566,0,0,0,0,0,1,0,1
4568,1,0,0,0,0,0,0,1
4569,1,0,0,0,0,0,0,1
4570,1,2,0,0,0,0,0,3
4571,3,0,0,0,0,0,0,3
4578,1,0,0,0,0,0,0,1
4581,1,0,0,0,0,0,0,1
4583,1,0,0,0,0,0,0,1
4584,1,0,0,0,0,0,0,1
4585,1,0,0,0,0,0,0,1
4588,2,0,0,0,0,0,0,2
4589,0,1,0,0,0,0,0,1
4590,1,0,0,0,0,0,0,1
4593,1,0,0,0,0,1,0,2
4596,2,0,0,0,0,0,0,2
4597,0,1,0,0,0,0,0,1
4598,1,0,0,0,0,0,0,1
4599,1,0,0,0,0,0,0,1
4601,1,0,0,0,0,0,0,1
4603,3,0,0,0,0,0,0,3
4604,1,0,0,0,0,0,0,1
4605,1,0,0,0,0,0,0,1
4606,1,0,0,0,0,0,0,1
4607,2,0,0,0,0,0,0,2
4608,0,0,1,0,0,0,0,1
4609,0,1,0,0,0,0,0,1
4612,1,0,1,0,0,0,0,2
4613,1,0,0,0,0,0,0,1
4614,1,0,0,0,0,0,0,1
4618,1,0,0,0,0,0,0,1
4619,2,0,0,0,0,0,0,2
4620,1,0,0,0,0,0,0,1
4623,1,0,0,0,0,0,0,1
4624,1,0,0,0,0,0,0,1
4625,0,0,0,0,0,1,0,1
4627,3,0,0,0,0,0,0,3
4628,0,1,0,0,0,0,0,1
4631,3,1,0,0,0,1,0,5
4633,4,0,0,0,0,0,0,4
4634,1,0,1,0,0,0,0,2
4637,0,0,1,0,0,0,0,1
4638,1,0,0,0,0,0,0,1
4639,1,0,0,0,0,0,0,1
4640,1,0,0,0,0,0,0,1
4641,2,0,0,0,0,0,0,2
4643,1,0,0,0,0,0,0,1
4644,1,0,0,0,0,0,0,1
4647,1,0,0,0,0,0,0,1
4651,4,0,2,0,0,0,0,6
4655,2,0,0,0,0,0,0,2
4656,2,0,0,0,0,0,0,2
4660,2,0,0,0,0,0,0,2
4661,2,0,0,0,0,0,0,2
4664,1,0,0,0,0,0,0,1
4667,1,0,0,0,0,0,0,1
4668,1,0,0,0,0,0,0,1
4670,0,0,0,0,0,1,0,1
4671,1,0,0,0,0,0,0,1
4674,1,0,0,0,0,0,0,1
4675,1,0,0,0,0,0,0,1
4678,1,0,1,0,0,0,0,2
4680,2,0,0,0,0,0,0,2
4681,1,0,0,0,0,0,0,1
4685,1,0,0,0,0,0,0,1
4686,0,1,0,0,0,0,0,1
4687,1,0,0,0,0,0,0,1
4689,1,0,0,0,0,0,0,1
4694,0,0,0,0,0,1,0,1
4695,1,1,0,0,0,0,0,2
4696,1,0,0,0,0,0,0,1
4697,1,0,0,0,0,0,0,1
4698,1,0,0,0,0,0,0,1
4699,1,0,0,0,0,0,0,1
4700,3,0,0,0,0,0,0,3
4701,2,0,0,0,0,1,0,3
4702,1,1,0,0,0,0,0,2
4707,1,0,0,0,0,0,0,1
4708,1,0,0,0,0,0,0,1
4710,0,1,0,0,0,0,0,1
4711,1,0,0,0,0,0,0,1
4712,3,0,0,0,0,0,0,3
4716,2,1,0,0,0,0,0,3
4719,1,0,0,0,0,0,0,1
4720,1,0,0,0,0,0,0,1
4721,1,0,0,0,0,0,0,1
4725,1,0,0,0,0,0,0,1
4728,2,0,0,0,0,0,0,2
4730,0,1,0,0,0,0,0,1
4731,1,0,0,0,0,0,0,1
4733,2,0,1,0,0,0,0,3
4735,1,0,0,0,0,0,0,1
4736,0,0,1,0,0,0,0,1
4737,2,0,0,0,0,0,0,2
4739,1,0,0,0,0,0,0,1
4740,1,0,0,0,0,0,0,1
4741,1,1,0,0,0,0,0,2
4742,2,0,0,0,0,0,0,2
4744,1,0,0,0,0,0,0,1
4747,1,0,0,0,0,0,0,1
4749,3,0,0,0,0,0,0,3
4751,1,0,0,0,0,0,0,1
4755,1,0,0,0,0,0,0,1
4756,1,0,0,0,0,0,0,1
4757,2,1,0,0,0,0,0,3
4761,1,0,0,0,0,0,0,1
4762,1,0,0,0,0,0,0,1
4763,1,0,0,0,0,0,0,1
4764,1,0,0,0,0,0,0,1
4765,1,0,0,0,0,0,0,1
4767,2,0,0,0,0,0,0,2
4772,0,0,1,0,0,1,0,2
4773,1,0,1,0,0,0,0,2
4774,6,0,0,0,0,0,0,6
4777,1,0,0,0,0,0,0,1
4778,0,1,0,0,0,0,0,1
4782,1,0,0,0,0,0,0,1
4784,1,0,1,0,0,0,0,2
4787,1,0,0,0,0,0,0,1
4788,3,0,0,0,0,0,0,3
4789,1,0,0,0,0,0,0,1
4790,1,0,0,0,0,0,0,1
4792,0,0,0,0,0,1,0,1
4794,1,0,0,0,0,0,0,1
4795,1,0,0,0,0,0,0,1
4797,1,0,0,0,0,0,0,1
4800,1,0,0,0,0,1,0,2
4801,1,0,0,0,0,0,0,1
4803,1,0,0,0,0,0,0,1
4806,1,0,0,0,0,0,0,1
4807,1,0,0,0,0,0,0,1
4809,3,0,0,0,0,0,0,3
4811,1,0,0,0,0,0,0,1
4812,1,0,0,0,0,0,0,1
4813,2,0,0,0,0,0,0,2
4814,2,1,1,0,0,0,0,4
4818,2,0,0,0,0,0,0,2
4819,0,0,0,0,0,1,0,1
4820,2,0,0,0,0,0,0,2
4822,2,0,0,0,0,0,0,2
4823,1,0,0,0,0,0,0,1
4827,1,0,0,0,0,0,0,1
4835,2,1,0,0,0,0,0,3
4836,1,0,0,0,0,0,0,1
4837,1,0,0,0,0,0,0,1
4838,1,0,0,0,0,1,0,2
4842,3,0,0,0,0,0,0,3
4843,1,0,0,0,0,0,0,1
4846,2,0,0,0,0,0,0,2
4847,2,0,0,0,0,0,0,2
4848,1,0,0,0,0,0,0,1
4852,1,0,0,0,0,0,0,1
4853,2,0,0,0,0,0,0,2
4854,2,0,0,0,0,0,0,2
4856,2,0,0,0,0,0,0,2
4857,1,0,0,0,0,0,0,1
4858,1,0,0,0,0,0,0,1
4860,1,0,1,0,0,0,0,2
4861,1,0,0,0,0,0,0,1
4863,2,0,0,0,0,0,0,2
4867,1,0,0,0,0,0,0,1
4869,1,0,0,0,0,0,0,1
4874,3,0,0,0,0,0,0,3
4876,1,0,0,0,0,0,0,1
4878,1,0,0,0,0,0,0,1
4879,1,0,0,0,0,0,0,1
4883,0,0,1,0,0,0,0,1
4884,2,0,0,0,0,0,0,2
4887,1,0,0,0,0,0,0,1
4888,0,0,1,0,0,0,0,1
4890,0,0,1,0,0,0,0,1
4891,1,0,0,1,0,0,0,2
4896,7,2,2,0,0,0,0,11
4897,1,0,0,0,0,0,0,1
4898,2,1,0,0,0,1,0,4
4899,1,0,0,0,0,0,0,1
4900,3,0,0,0,0,0,0,3
4906,2,0,0,0,0,0,0,2
4907,2,0,0,0,0,0,0,2
4908,1,0,0,0,0,0,0,1
4910,2,0,1,0,0,0,0,3
4911,2,0,0,0,0,0,0,2
4912,2,0,0,0,0,0,0,2
4914,2,0,0,0,0,0,0,2
4917,2,0,0,0,0,0,0,2
4918,1,0,0,0,0,0,0,1
4919,1,0,0,0,0,0,0,1
4920,1,0,1,0,0,0,0,2
4922,0,0,1,0,0,0,0,1
4923,1,0,0,0,0,0,0,1
4928,1,0,0,0,0,0,0,1
4932,0,0,0,0,0,1,0,1
4933,2,0,0,0,0,0,0,2
4934,1,0,0,0,0,0,0,1
4935,1,0,0,0,0,0,0,1
4936,1,0,0,0,0,0,0,1
4939,1,0,0,0,0,0,0,1
4940,2,0,0,0,0,0,0,2
4942,2,0,0,0,0,0,0,2
4943,1,0,0,0,0,0,0,1
4944,1,0,0,0,0,0,0,1
4945,1,0,1,0,0,0,0,2
4946,1,0,0,0,0,0,0,1
4955,0,0,1,0,0,0,0,1
4957,2,1,0,0,0,0,0,3
4958,1,0,0,0,0,0,0,1
4960,1,0,0,0,0,0,0,1
4963,1,0,0,0,0,0,0,1
4964,1,0,0,0,0,0,0,1
4970,0,0,1,0,0,0,0,1
4974,1,0,0,0,0,0,0,1
4977,1,0,0,0,0,0,0,1
4978,5,0,0,0,0,0,0,5
4979,0,0,1,0,0,0,0,1
4980,1,0,1,0,0,0,0,2
4981,0,0,1,0,0,0,0,1
4982,2,1,0,0,0,0,0,3
4983,2,0,0,0,0,0,0,2
4984,1,0,0,0,0,0,0,1
4986,2,0,0,0,0,0,0,2
4987,1,0,0,0,0,0,0,1
4988,1,0,0,0,0,0,0,1
4989,1,0,0,0,0,0,0,1
4990,1,0,0,0,0,0,0,1
4992,2,0,0,0,0,0,0,2
4999,0,0,0,0,0,1,0,1
5009,1,0,0,0,0,0,0,1
5011,1,0,0,0,0,0,0,1
5017,2,0,0,0,0,0,0,2
5018,1,0,0,0,0,0,0,1
5019,2,0,0,0,0,0,0,2
5020,3,0,1,0,0,0,0,4
5032,1,0,0,0,0,0,0,1
5033,1,0,0,0,0,0,0,1
5034,1,0,0,0,0,0,0,1
5035,0,0,1,0,0,0,0,1
5036,1,0,0,0,0,0,0,1
5037,1,0,0,0,0,0,0,1
5040,1,0,1,0,0,0,0,2
5045,1,0,0,0,0,0,0,1
5046,1,0,0,0,0,0,0,1
5047,1,0,0,0,0,0,0,1
5048,1,0,0,0,0,0,0,1
5051,0,0,1,0,0,0,0,1
5052,1,0,0,0,0,0,0,1
5053,3,0,0,0,0,0,0,3
5054,1,0,0,0,0,0,0,1
5055,1,0,0,0,0,0,0,1
5057,1,0,0,0,0,0,0,1
5058,0,0,1,0,0,0,0,1
5059,1,0,1,0,0,0,0,2
5060,1,0,0,0,0,0,0,1
5062,1,0,0,0,0,0,0,1
5065,1,0,0,0,0,0,0,1
5068,1,0,0,0,0,0,0,1
5071,2,0,0,0,0,0,0,2
5073,1,0,1,0,0,0,0,2
5074,1,0,0,0,0,0,0,1
5077,1,0,0,0,0,0,0,1
5079,0,0,1,0,0,0,0,1
5080,2,0,0,0,0,0,0,2
5082,1,0,0,0,0,0,0,1
5083,1,0,0,0,0,0,0,1
5087,1,0,1,0,0,0,0,2
5093,2,0,0,0,0,0,0,2
5096,1,0,0,0,0,0,0,1
5098,1,0,0,0,0,0,0,1
5099,1,0,1,0,0,0,0,2
5107,0,0,1,0,0,0,0,1
5109,1,0,0,0,0,0,0,1
5114,2,0,0,0,0,0,0,2
5116,3,0,0,0,0,0,0,3
5118,1,0,0,0,0,0,0,1
5121,1,0,0,0,0,0,0,1
5123,1,0,0,0,0,0,0,1
5126,1,0,0,0,0,0,0,1
5128,1,0,0,0,0,0,0,1
5129,1,0,0,0,0,1,0,2
5131,1,0,2,0,0,0,0,3
5132,1,0,0,0,0,0,0,1
5137,2,0,0,0,0,0,0,2
5141,0,1,0,1,0,1,0,3
5142,1,0,0,0,0,0,0,1
5143,2,0,0,0,0,0,0,2
5145,1,0,0,0,0,0,0,1
5146,1,0,0,0,0,0,0,1
5150,1,0,0,0,0,0,0,1
5152,0,1,0,0,0,0,0,1
5154,0,1,0,0,0,0,0,1
5159,0,0,0,0,0,1,0,1
5160,0,1,1,0,0,0,0,2
5163,1,0,0,0,0,0,0,1
5169,1,0,0,0,0,0,0,1
5172,1,0,0,0,0,0,0,1
5178,1,0,0,0,0,0,0,1
5179,2,0,0,0,0,0,0,2
5183,1,0,0,0,0,0,0,1
5184,1,0,0,0,0,0,0,1
5187,1,0,0,0,0,0,0,1
5188,1,0,0,0,0,0,0,1
5194,2,0,0,0,0,0,0,2
5195,1,0,0,0,0,0,0,1
5196,1,0,0,0,0,0,0,1
5197,1,0,1,0,0,0,0,2
5198,1,0,1,0,0,0,0,2
5199,1,0,0,0,0,0,0,1
5200,1,0,0,0,0,0,0,1
5205,2,0,0,0,0,0,0,2
5206,3,0,0,0,0,0,0,3
5207,2,0,0,0,0,0,0,2
5208,1,0,0,0,0,0,0,1
5209,1,0,0,0,0,1,0,2
5210,2,0,0,0,0,0,0,2
5213,1,0,0,0,0,0,0,1
5215,1,0,0,0,0,0,0,1
5216,1,0,0,0,0,0,0,1
5218,3,0,0,0,0,0,0,3
5221,0,0,1,0,0,0,0,1
5222,2,0,0,0,0,0,0,2
5223,1,0,0,0,0,0,0,1
5225,1,0,0,0,0,0,0,1
5227,1,0,1,0,0,0,0,2
5228,1,0,0,0,0,0,0,1
5230,1,0,0,0,0,0,0,1
5237,1,0,0,0,0,0,0,1
5242,1,0,0,0,0,0,0,1
5247,1,0,0,0,0,0,0,1
5248,1,0,0,0,0,0,0,1
5250,5,0,3,0,0,0,0,8
5251,3,0,0,0,0,0,0,3
5252,2,0,0,0,0,0,0,2
5253,1,0,0,0,0,0,0,1
5255,2,0,0,0,0,0,0,2
5263,1,2,0,0,0,1,0,4
5264,1,0,0,0,0,0,0,1
5267,1,0,0,0,0,0,0,1
5268,2,0,0,0,0,0,0,2
5271,2,0,0,0,0,0,0,2
5273,0,0,1,0,0,0,0,1
5275,1,0,0,0,0,0,0,1
5277,1,0,0,0,0,0,0,1
5278,1,0,0,0,0,0,0,1
5279,1,0,0,0,0,0,0,1
5280,2,0,0,0,0,0,0,2
5282,1,0,0,0,0,0,0,1
5285,0,0,1,0,0,0,0,1
5286,0,0,1,0,0,0,0,1
5290,1,0,0,0,0,0,0,1
5291,1,0,0,0,0,0,0,1
5293,1,0,0,0,0,0,0,1
5294,1,0,0,0,0,0,0,1
5295,1,0,0,0,0,0,0,1
5297,1,0,0,0,0,0,0,1
5299,1,0,0,0,0,0,0,1
5300,1,0,0,0,0,0,0,1
5301,1,0,0,0,0,0,0,1
5303,1,1,0,0,0,0,0,2
5304,2,1,1,0,0,0,0,4
5306,1,0,1,0,0,0,0,2
5309,1,0,0,0,0,0,0,1
5311,1,0,0,0,0,0,0,1
5312,1,0,0,0,0,0,0,1
5316,1,0,0,0,0,0,0,1
5319,1,0,0,0,0,0,0,1
5322,0,0,1,0,0,0,0,1
5323,1,0,0,0,0,0,0,1
5324,4,1,1,0,0,0,0,6
5325,2,0,0,0,0,0,0,2
5327,1,1,0,0,0,0,0,2
5332,1,0,0,0,0,0,0,1
5341,3,0,0,0,0,0,0,3
5342,1,0,0,0,0,0,0,1
5343,1,0,0,0,0,0,0,1
5344,0,0,2,0,0,0,0,2
5345,1,0,0,0,0,0,0,1
5347,1,0,0,0,0,0,0,1
5348,1,0,0,0,0,0,0,1
5352,1,0,0,0,0,0,0,1
5354,1,0,0,0,0,0,0,1
5355,2,0,0,0,0,0,0,2
5356,0,0,0,0,0,1,0,1
5357,2,0,0,0,0,0,0,2
5358,0,0,1,0,0,0,0,1
5360,0,1,0,0,0,0,0,1
5362,0,0,0,0,0,1,0,1
5363,1,0,0,0,0,0,0,1
5367,1,0,1,0,0,0,0,2
5368,1,0,0,0,0,0,0,1
5374,2,0,0,0,0,0,0,2
5378,3,0,0,0,0,0,0,3
5381,1,0,0,0,0,0,0,1
5383,1,0,0,0,0,0,0,1
5385,1,0,0,0,0,0,0,1
5386,6,0,1,0,0,1,0,8
5388,1,0,2,0,0,0,0,3
5389,2,0,0,0,0,0,0,2
5392,1,0,0,0,0,0,0,1
5397,2,0,0,0,0,0,0,2
5400,1,1,0,0,0,0,0,2
5401,0,0,0,0,0,1,0,1
5402,1,0,0,0,0,0,0,1
5404,1,0,0,0,0,0,0,1
5405,2,0,0,0,0,0,0,2
5406,1,0,0,0,0,0,0,1
5409,2,0,0,0,0,0,0,2
5411,1,0,0,0,0,0,0,1
5412,1,0,0,0,0,0,0,1
5413,2,0,0,0,0,0,0,2
5414,1,0,0,0,0,0,0,1
5420,1,0,0,0,0,0,0,1
5422,1,0,0,0,0,0,0,1
5423,1,0,0,0,0,0,0,1
5425,1,0,0,0,0,0,0,1
5432,0,0,1,0,0,0,0,1
5436,1,0,0,0,0,0,0,1
5437,1,0,0,0,0,0,0,1
5439,0,0,0,0,0,1,0,1
5441,0,0,1,0,0,0,0,1
5444,2,0,0,0,0,0,0,2
5446,1,0,0,0,0,0,0,1
5447,4,0,1,0,0,0,0,5
5450,1,0,0,0,0,0,0,1
5452,1,1,0,0,0,0,0,2
5455,1,0,0,0,0,0,0,1
5456,0,0,1,0,0,0,0,1
5458,2,0,0,0,0,0,0,2
5460,1,0,0,0,0,0,0,1
5463,2,0,2,0,0,0,0,4
5465,2,0,0,0,0,0,0,2
5467,2,0,0,0,0,0,0,2
5468,1,0,0,0,0,0,0,1
5470,0,1,1,0,0,0,0,2
5471,1,0,0,0,0,0,0,1
5474,1,0,0,0,0,0,0,1
5475,1,0,0,0,0,0,0,1
5477,0,0,0,0,0,1,0,1
5479,2,0,0,0,0,0,0,2
5480,1,0,0,0,0,0,0,1
5481,0,0,1,0,0,0,0,1
5483,1,0,0,0,0,0,0,1
5489,1,0,0,0,0,0,0,1
5495,0,0,0,0,0,1,0,1
5502,0,0,1,0,0,0,0,1
5504,1,0,0,0,0,0,0,1
5507,1,0,0,0,0,0,0,1
5508,4,0,0,0,0,0,0,4
5510,1,0,0,0,0,0,0,1
5512,1,0,0,0,0,0,0,1
5513,2,0,0,0,0,0,0,2
5520,0,0,0,0,0,1,0,1
5521,1,0,0,0,0,0,0,1
5524,1,0,0,0,0,0,0,1
5525,1,0,0,0,0,0,0,1
5526,1,0,0,0,0,0,0,1
5527,1,0,0,0,0,0,0,1
5534,0,0,1,0,0,0,0,1
5538,1,0,0,0,0,0,0,1
5539,1,0,0,0,0,0,0,1
5541,0,0,1,0,0,0,0,1
5543,1,0,0,0,0,0,0,1
5544,1,0,0,0,0,0,0,1
5545,1,0,0,0,0,0,0,1
5546,0,0,1,0,0,0,0,1
5551,2,0,0,0,0,0,0,2
5553,1,0,1,0,0,0,0,2
5557,0,0,1,0,0,0,0,1
5563,1,0,0,0,0,0,0,1
5565,1,0,0,0,0,0,0,1
5567,0,0,1,0,0,0,0,1
5568,1,0,0,0,0,0,0,1
5569,2,0,1,0,0,0,0,3
5571,0,0,1,0,0,0,0,1
5572,1,0,0,0,0,0,0,1
5573,2,0,0,0,0,0,0,2
5574,0,0,1,0,0,0,0,1
5580,1,0,0,0,0,1,0,2
5581,2,0,0,0,0,0,0,2
5587,1,0,0,0,0,0,0,1
5590,1,0,0,0,0,0,0,1
5591,1,0,0,0,0,0,0,1
5593,1,0,0,0,0,0,0,1
5600,2,0,1,0,0,0,0,3
5603,1,0,0,0,0,0,0,1
5610,1,0,0,0,0,0,0,1
5612,0,1,1,0,0,0,0,2
5614,3,0,0,0,0,0,0,3
5616,0,1,0,0,0,0,0,1
5620,1,0,0,0,0,0,0,1
5622,1,0,0,0,0,0,0,1
5629,1,0,0,0,0,0,0,1
5630,9,2,3,0,0,0,0,14
5634,0,0,1,0,0,0,0,1
5636,1,0,0,0,0,0,0,1
5640,1,0,0,0,0,0,0,1
5641,2,0,0,0,0,0,0,2
5649,1,0,0,0,0,0,0,1
5650,0,1,0,0,0,0,0,1
5651,2,1,0,0,0,0,0,3
5652,1,0,0,0,0,0,0,1
5659,2,0,0,0,0,0,0,2
5661,1,0,0,0,0,0,0,1
5669,1,0,0,0,0,0,0,1
5672,1,0,0,0,0,0,0,1
5673,1,0,0,0,0,0,0,1
5676,2,0,0,0,0,0,0,2
5678,1,0,0,0,0,0,0,1
5680,1,0,0,0,0,0,0,1
5682,2,0,0,0,0,0,0,2
5685,1,0,0,0,0,0,0,1
5686,2,0,0,0,0,0,0,2
5692,3,0,2,0,0,0,0,5
5695,2,0,0,0,0,1,0,3
5700,1,0,0,0,0,0,0,1
5703,0,1,0,0,0,0,0,1
5705,0,0,1,0,0,0,0,1
5712,2,0,0,0,0,0,0,2
5715,1,0,0,0,0,0,0,1
5721,0,1,0,0,0,0,0,1
5722,0,1,0,0,0,0,0,1
5723,1,0,0,0,0,0,0,1
5725,0,0,0,0,0,1,0,1
5728,1,0,0,0,0,0,0,1
5729,1,0,0,0,0,0,0,1
5733,1,0,0,0,0,0,0,1
5736,1,0,0,0,0,0,0,1
5738,1,0,0,0,0,0,0,1
5740,1,0,0,0,0,0,0,1
5742,1,0,0,0,0,0,0,1
5751,1,0,0,0,0,0,0,1
5753,1,0,1,0,0,0,0,2
5754,1,0,0,0,0,0,0,1
5757,2,0,0,0,0,0,0,2
5759,1,0,0,0,0,0,0,1
5760,0,0,0,0,0,1,0,1
5761,2,0,0,0,0,0,0,2
5762,1,0,0,0,0,0,0,1
5767,1,0,0,0,0,0,0,1
5770,2,0,0,0,0,0,0,2
5780,1,0,0,0,0,0,0,1
5785,1,0,0,0,0,0,0,1
5788,1,0,1,0,0,0,0,2
5794,2,0,0,0,0,0,0,2
5796,0,0,1,0,0,0,0,1
5799,1,0,0,0,0,0,0,1
5804,1,0,0,0,0,0,0,1
5814,3,0,0,0,0,0,0,3
5816,1,0,0,0,0,0,0,1
5820,1,0,0,0,0,0,0,1
5823,0,0,1,0,0,0,0,1
5826,1,0,0,0,0,0,0,1
5831,1,0,0,0,0,0,0,1
5835,1,0,0,0,0,0,0,1
5836,0,0,1,0,0,0,0,1
5837,2,0,0,0,0,0,0,2
5838,0,1,0,0,0,0,0,1
5839,1,0,0,0,0,0,0,1
5840,1,0,0,0,0,0,0,1
5851,1,0,1,0,0,0,0,2
5855,1,0,0,0,0,0,0,1
5857,1,0,0,0,0,0,0,1
5860,1,0,0,0,0,0,0,1
5861,0,0,0,0,0,1,0,1
5862,1,0,0,0,0,0,0,1
5864,1,0,0,0,0,0,0,1
5868,1,0,0,0,0,0,0,1
5870,1,0,0,0,0,0,0,1
5872,1,0,0,0,0,0,0,1
5875,6,0,4,1,0,0,0,11
5876,0,1,0,0,0,0,0,1
5880,1,0,0,0,0,0,0,1
5883,1,0,0,0,0,0,0,1
5885,1,0,0,0,0,0,0,1
5886,1,0,0,0,0,0,0,1
5888,1,0,0,0,0,0,0,1
5892,1,0,0,0,0,0,0,1
5893,1,0,0,0,0,0,0,1
5898,1,0,0,0,0,0,0,1
5902,1,0,0,0,0,0,0,1
5907,1,0,0,0,0,0,0,1
5908,1,0,0,0,0,0,0,1
5909,1,0,0,0,0,0,0,1
5910,0,0,1,0,0,0,0,1
5911,2,0,0,0,0,0,0,2
5914,1,0,0,0,0,0,0,1
5918,1,0,0,0,0,0,0,1
5919,2,0,0,0,0,0,0,2
5920,1,0,0,0,0,0,0,1
5921,1,0,0,0,0,0,0,1
5922,1,0,0,0,0,0,0,1
5930,1,0,0,0,0,0,0,1
5934,0,0,1,0,0,0,0,1
5938,1,0,0,0,0,0,0,1
5943,1,0,1,0,0,0,0,2
5944,0,0,1,0,0,0,0,1
5945,1,0,0,0,0,0,0,1
5947,2,0,0,0,0,0,0,2
5951,1,0,0,0,0,0,0,1
5952,0,0,0,0,0,1,0,1
5954,1,0,0,0,0,0,0,1
5957,3,0,1,0,0,0,0,4
5959,0,0,1,0,0,0,0,1
5960,0,0,0,0,0,1,0,1
5969,2,0,0,0,0,0,0,2
5970,0,0,0,0,0,1,0,1
5972,0,0,1,0,0,0,0,1
5979,1,0,0,0,0,0,0,1
5981,0,1,0,0,0,0,0,1
5986,2,0,0,0,0,0,0,2
5994,1,0,0,0,0,0,0,1
5995,0,0,2,0,0,0,0,2
5998,3,0,1,0,0,0,0,4
6000,1,0,0,0,0,0,0,1
6004,1,0,0,0,0,0,0,1
6005,1,0,0,0,0,0,0,1
6006,1,0,0,0,0,0,0,1
6009,0,0,0,0,0,1,0,1
6013,1,0,0,0,0,0,0,1
6014,1,0,0,0,0,0,0,1
6018,1,0,0,0,0,0,0,1
6019,1,0,0,0,0,0,0,1
6020,1,0,0,0,0,0,0,1
6021,1,0,0,0,0,0,0,1
6028,1,0,0,0,0,0,0,1
6031,1,0,0,0,0,0,0,1
6032,1,0,0,0,0,0,0,1
6038,2,2,0,0,0,0,0,4
6046,0,1,0,0,0,0,0,1
6052,0,0,0,0,0,1,0,1
6053,1,0,0,0,0,0,0,1
6059,1,0,0,0,0,0,0,1
6068,0,0,1,0,0,0,0,1
6069,1,0,0,0,0,0,0,1
6071,1,1,0,0,0,0,0,2
6075,1,0,0,0,0,0,0,1
6076,1,0,0,0,0,0,0,1
6079,0,0,1,0,0,1,0,2
6080,1,0,0,0,0,0,0,1
6085,2,0,0,0,0,0,0,2
6094,1,0,0,0,0,0,0,1
6102,1,0,0,0,0,0,0,1
6106,0,0,1,0,0,0,0,1
6107,1,0,0,0,0,0,0,1
6108,1,0,0,0,0,0,0,1
6109,0,0,1,0,0,0,0,1
6110,2,0,0,0,0,0,0,2
6113,1,0,0,0,0,0,0,1
6114,1,0,0,0,0,0,0,1
6116,1,0,0,0,0,0,0,1
6120,5,1,1,0,0,0,0,7
6122,1,0,0,0,0,0,0,1
6124,2,0,0,0,0,0,0,2
6125,0,0,1,0,0,0,0,1
6129,1,0,0,0,0,0,0,1
6131,1,0,0,0,0,0,0,1
6133,0,0,1,0,0,0,0,1
6138,1,0,0,0,0,0,0,1
6139,1,0,0,0,0,0,0,1
6140,1,0,0,0,0,0,0,1
6141,2,0,0,0,0,0,0,2
6146,1,0,0,0,0,1,0,2
6148,1,0,0,0,0,0,0,1
6152,0,0,0,0,0,1,0,1
6153,3,0,0,0,0,0,0,3
6154,1,0,0,0,0,0,0,1
6155,0,0,0,0,0,1,0,1
6170,1,0,0,0,0,0,0,1
6181,1,0,0,0,0,0,0,1
6182,0,1,1,0,0,0,0,2
6184,2,0,0,0,0,0,0,2
6186,0,0,0,0,0,1,0,1
6191,1,0,0,0,0,0,0,1
6198,0,0,1,0,0,0,0,1
6199,1,0,0,0,0,0,0,1
6202,1,0,0,0,0,0,0,1
6204,2,0,0,0,0,0,0,2
6209,1,0,0,0,0,0,0,1
6210,1,0,0,0,0,0,0,1
6211,1,0,0,0,0,0,0,1
6212,1,0,0,0,0,0,0,1
6219,0,0,1,0,0,0,0,1
6220,1,0,0,0,0,0,0,1
6230,3,0,0,0,0,0,0,3
6231,1,0,0,0,0,0,0,1
6234,2,0,1,0,0,0,0,3
6238,2,0,0,0,0,0,0,2
6240,2,0,1,0,0,0,0,3
6242,2,0,0,0,0,0,0,2
6247,1,0,0,0,0,0,0,1
6250,1,0,0,0,0,0,0,1
6251,1,0,0,0,0,0,0,1
6253,1,0,0,0,0,0,0,1
6254,0,0,0,0,0,1,0,1
6258,1,0,0,0,0,0,0,1
6259,1,0,0,0,0,0,0,1
6260,1,0,0,0,0,0,0,1
6268,1,0,0,0,0,0,0,1
6269,1,0,0,0,0,0,0,1
6272,0,1,0,0,0,0,0,1
6275,1,0,0,0,0,0,0,1
6278,1,0,0,0,0,0,0,1
6279,2,0,0,0,0,0,0,2
6283,2,0,0,0,0,0,0,2
6284,1,0,0,0,0,0,0,1
6286,2,0,0,0,0,0,0,2
6290,1,0,0,0,0,0,0,1
6291,1,0,0,0,0,0,0,1
6292,0,0,0,0,0,1,0,1
6296,0,1,0,0,0,0,0,1
6300,0,0,1,0,0,0,0,1
6301,0,0,1,0,0,0,0,1
6304,3,0,0,0,0,0,0,3
6307,1,0,0,0,0,0,0,1
6312,1,0,0,0,0,0,0,1
6314,1,0,0,0,0,0,0,1
6321,1,0,0,0,0,0,0,1
6322,1,0,0,0,0,0,0,1
6324,1,0,1,0,0,0,0,2
6327,1,0,0,0,0,0,0,1
6329,0,1,0,0,0,0,0,1
6330,0,0,1,0,0,0,0,1
6334,0,0,1,0,0,0,0,1
6337,1,0,0,0,0,0,0,1
6343,1,0,0,0,0,0,0,1
6349,1,0,0,0,0,0,0,1
6350,1,0,0,0,0,0,0,1
6357,1,1,0,0,0,0,0,2
6358,1,0,0,0,0,0,0,1
6360,2,0,1,0,0,0,0,3
6362,1,0,0,0,0,0,0,1
6365,4,2,0,0,0,1,0,7
6366,1,0,0,0,0,0,0,1
6372,0,1,0,0,0,0,0,1
6375,1,0,0,0,0,0,0,1
6376,1,0,0,0,0,0,0,1
6378,1,0,0,0,0,0,0,1
6385,1,0,0,0,0,0,0,1
6391,1,0,0,0,0,0,0,1
6397,0,0,0,0,0,1,0,1
6400,1,0,0,0,0,0,0,1
6401,0,0,1,0,0,0,0,1
6405,2,0,0,0,0,0,0,2
6413,1,0,0,0,0,0,0,1
6415,0,0,0,0,0,1,0,1
6416,1,0,0,0,0,0,0,1
6421,1,0,0,0,0,0,0,1
6426,0,0,1,0,0,0,0,1
6429,1,0,0,0,0,0,0,1
6432,0,0,1,0,0,0,0,1
6434,1,0,0,0,0,0,0,1
6437,1,0,0,0,0,0,0,1
6438,1,0,0,0,0,0,0,1
6441,1,0,0,0,0,0,0,1
6442,1,0,0,0,0,0,0,1
6443,1,0,0,0,0,0,0,1
6446,1,0,2,0,0,0,0,3
6450,2,0,0,0,0,0,0,2
6453,1,0,0,0,0,0,0,1
6459,1,0,0,0,0,0,0,1
6462,1,0,0,0,0,0,0,1
6465,1,0,0,0,0,0,0,1
6469,0,0,1,0,0,0,0,1
6470,1,0,0,0,0,0,0,1
6472,1,0,0,0,0,0,0,1
6473,1,0,0,0,0,0,0,1
6477,1,0,0,0,0,0,0,1
6479,0,1,0,0,0,0,0,1
6480,0,1,1,0,0,0,0,2
6484,1,0,0,0,0,0,0,1
6487,4,0,0,0,0,0,0,4
6488,1,0,0,0,0,0,0,1
6496,1,0,0,0,0,0,0,1
6500,0,0,0,0,0,1,0,1
6501,2,0,0,0,0,0,0,2
6503,1,0,0,0,0,0,0,1
6521,0,0,1,0,0,0,0,1
6523,0,0,1,0,0,0,0,1
6524,1,0,0,0,0,0,0,1
6528,2,0,0,0,0,0,0,2
6536,0,0,1,0,0,0,0,1
6537,2,0,1,0,0,0,0,3
6538,0,0,1,0,0,0,0,1
6540,0,1,0,0,0,0,0,1
6541,1,0,1,0,0,0,0,2
6546,1,0,0,0,0,0,0,1
6547,1,0,0,0,0,0,0,1
6548,4,0,0,0,0,0,0,4
6550,1,0,0,0,0,0,0,1
6551,2,0,0,0,0,0,0,2
6556,1,0,0,0,0,0,0,1
6558,1,0,0,0,0,0,0,1
6559,1,0,0,0,0,0,0,1
6569,0,0,1,0,0,0,0,1
6570,1,0,0,0,0,0,0,1
6572,1,0,0,0,0,0,0,1
6575,1,0,0,0,0,0,0,1
6586,0,0,0,0,0,1,0,1
6593,1,0,0,0,0,0,0,1
6600,2,0,0,0,0,0,0,2
6601,1,0,0,0,0,0,0,1
6602,1,0,0,0,0,0,0,1
6609,1,0,0,0,0,0,0,1
6610,6,1,0,0,0,0,0,7
6611,0,0,0,1,0,0,0,1
6616,0,1,0,0,0,0,0,1
6617,1,0,0,0,0,0,0,1
6618,1,0,0,0,0,0,0,1
6620,1,0,0,0,0,0,0,1
6622,1,0,0,0,0,0,0,1
6632,2,0,0,0,0,0,0,2
6635,1,0,0,0,0,0,0,1
6638,1,0,0,0,0,0,0,1
6640,0,1,0,0,0,0,0,1
6644,2,0,0,0,0,0,0,2
6645,1,0,1,0,0,0,0,2
6646,0,0,1,0,0,0,0,1
6648,1,0,0,0,0,0,0,1
6649,1,0,0,0,0,0,0,1
6650,0,0,0,1,0,0,0,1
6651,1,0,0,0,0,0,0,1
6653,0,0,1,0,0,0,0,1
6654,1,0,0,0,0,0,0,1
6659,1,0,0,0,0,0,0,1
6660,1,0,0,0,0,0,0,1
6664,1,0,0,0,0,0,0,1
6667,1,0,0,0,0,0,0,1
6670,1,0,0,0,0,0,0,1
6671,3,1,0,0,0,0,0,4
6673,0,0,0,0,0,1,0,1
6675,2,0,0,0,0,0,0,2
6678,1,0,0,0,0,0,0,1
6681,1,0,0,0,0,0,0,1
6682,1,0,0,0,0,0,0,1
6687,0,0,1,0,0,0,0,1
6690,1,0,0,0,0,0,0,1
6691,0,0,1,0,0,0,0,1
6693,1,0,1,0,0,0,0,2
6695,1,0,0,0,0,0,0,1
6705,1,0,0,0,0,0,0,1
6708,1,0,0,0,0,0,0,1
6712,1,0,0,0,0,0,0,1
6715,0,0,1,0,0,0,0,1
6720,1,0,0,0,0,1,0,2
6722,1,0,0,0,0,0,0,1
6723,1,0,0,0,0,0,0,1
6724,1,0,0,0,0,0,0,1
6732,0,0,1,0,0,1,0,2
6735,1,0,0,0,0,0,0,1
6740,0,0,1,0,0,0,0,1
6742,1,0,0,0,0,0,0,1
6756,1,0,0,0,0,0,0,1
6758,1,1,0,0,0,0,0,2
6769,1,0,0,0,0,0,0,1
6773,2,0,0,0,0,0,0,2
6776,0,0,1,0,0,0,0,1
6778,0,1,0,0,0,0,0,1
6780,0,1,0,0,0,2,0,3
6781,2,0,0,0,0,0,0,2
6785,0,0,1,0,0,0,0,1
6793,2,1,1,0,0,0,0,4
6794,1,0,0,0,0,0,0,1
6795,1,0,0,0,0,1,0,2
6799,1,0,0,0,0,0,0,1
6800,0,0,1,0,0,0,0,1
6802,0,0,0,0,0,1,0,1
6806,0,0,1,0,0,0,0,1
6808,1,0,0,0,0,0,0,1
6810,0,0,1,0,0,0,0,1
6816,1,0,0,0,0,0,0,1
6817,1,0,0,0,0,0,0,1
6821,1,0,0,0,0,0,0,1
6823,1,0,0,0,0,0,0,1
6824,1,0,0,0,0,0,0,1
6838,1,0,0,0,0,0,0,1
6840,2,0,0,1,0,0,0,3
6843,1,0,0,0,0,0,0,1
6851,0,0,1,0,0,0,0,1
6853,2,0,0,0,0,0,0,2
6854,8,0,0,0,0,0,0,8
6857,1,0,0,0,0,0,0,1
6861,1,0,0,0,0,0,0,1
6869,1,0,0,0,0,0,0,1
6873,1,0,0,0,0,0,0,1
6874,1,0,0,0,0,0,0,1
6883,0,1,0,0,0,0,0,1
6885,1,0,0,0,0,0,0,1
6887,1,0,0,0,0,0,0,1
6896,0,1,0,0,0,0,0,1
6897,1,0,0,0,0,0,0,1
6899,1,0,0,0,0,0,0,1
6902,2,0,0,0,0,0,0,2
6906,1,0,0,0,0,1,0,2
6907,2,0,0,0,0,0,0,2
6909,1,0,0,0,0,0,0,1
6911,2,0,0,0,0,0,0,2
6914,1,0,0,0,0,0,0,1
6916,2,0,1,0,0,0,0,3
6920,1,0,1,0,0,0,0,2
6921,0,0,1,0,0,0,0,1
6927,1,0,0,0,0,0,0,1
6934,1,0,0,0,0,0,0,1
6936,2,0,1,0,0,0,0,3
6942,1,0,0,0,0,0,0,1
6944,1,0,0,0,0,0,0,1
6946,1,0,0,0,0,0,0,1
6949,0,0,1,0,0,0,0,1
6964,1,0,0,0,0,0,0,1
6965,1,0,0,0,0,0,0,1
6971,1,0,0,0,0,0,0,1
6975,1,0,0,0,0,0,0,1
6977,4,0,2,0,0,0,0,6
6982,1,0,0,0,0,0,0,1
6991,1,0,0,0,0,0,0,1
6999,0,0,1,0,0,0,0,1
7000,5,0,0,0,0,0,0,5
7002,1,0,0,0,0,0,0,1
7018,4,0,0,0,0,0,0,4
7021,1,0,0,0,0,0,0,1
7022,0,0,1,0,0,0,0,1
7029,0,0,1,0,0,0,0,1
7036,1,0,0,0,0,0,0,1
7038,0,1,1,0,0,0,0,2
7042,1,0,0,0,0,0,0,1
7043,1,1,0,0,0,0,0,2
7044,1,0,0,0,0,0,0,1
7046,1,0,0,0,0,0,0,1
7050,1,0,0,0,0,0,0,1
7054,1,0,1,0,0,0,0,2
7079,1,0,0,0,0,0,0,1
7080,0,0,1,0,0,1,0,2
7089,1,0,0,0,0,0,0,1
7096,0,0,1,0,0,0,0,1
7099,2,0,1,0,0,0,0,3
7103,1,0,0,0,0,0,0,1
7105,2,0,0,0,0,0,0,2
7112,1,0,0,0,0,0,0,1
7113,1,0,0,0,0,0,0,1
7115,1,0,0,0,0,0,0,1
7119,1,0,0,0,0,0,0,1
7121,1,0,0,0,0,0,0,1
7127,0,0,0,0,0,1,0,1
7133,1,0,0,0,0,0,0,1
7135,0,1,0,0,0,0,0,1
7146,1,0,0,0,0,0,0,1
7152,1,0,0,0,0,0,0,1
7156,1,0,1,0,0,0,0,2
7159,0,0,1,0,0,0,0,1
7160,2,0,0,0,0,0,0,2
7164,1,1,0,0,0,0,0,2
7166,1,0,0,0,0,0,0,1
7168,1,0,0,0,0,0,0,1
7170,1,0,0,0,0,0,0,1
7172,1,0,0,0,0,0,0,1
7181,2,0,0,1,0,0,0,3
7186,0,0,1,0,0,0,0,1
7190,1,0,0,0,0,0,0,1
7196,1,0,0,0,0,0,0,1
7198,1,0,0,0,0,0,0,1
7200,2,0,0,0,0,0,0,2
7205,1,0,0,0,0,0,0,1
7208,1,0,0,0,0,0,0,1
7211,1,0,0,0,0,0,0,1
7218,1,0,0,0,0,0,0,1
7220,1,0,0,0,0,0,0,1
7222,2,1,0,0,0,0,0,3
7230,1,0,0,0,0,0,0,1
7231,2,0,0,0,0,0,0,2
7236,1,0,0,0,0,0,0,1
7237,1,0,0,0,0,0,0,1
7244,1,0,1,0,0,0,0,2
7249,1,0,0,0,0,0,0,1
7252,0,0,1,0,0,0,0,1
7254,1,0,0,0,0,0,0,1
7255,1,0,0,0,0,0,0,1
7260,1,0,0,0,0,0,0,1
7262,1,0,0,0,0,0,0,1
7277,1,0,0,0,0,0,0,1
7283,2,0,0,0,0,0,0,2
7298,1,0,0,0,0,0,0,1
7302,2,0,0,0,0,0,0,2
7303,0,0,1,0,0,0,0,1
7316,1,0,0,0,0,0,0,1
7320,2,0,0,0,0,0,0,2
7322,0,0,0,0,0,1,0,1
7324,0,0,1,0,0,0,0,1
7327,1,0,0,0,0,0,0,1
7329,1,0,0,0,0,0,0,1
7336,1,0,0,0,0,0,0,1
7343,1,0,0,0,0,0,0,1
7344,4,1,0,1,0,0,0,6
7349,1,0,0,0,0,0,0,1
7350,0,0,1,0,0,0,0,1
7360,0,0,1,0,0,0,0,1
7372,0,0,1,0,0,0,0,1
7377,1,0,0,0,0,0,0,1
7378,0,0,1,0,0,0,0,1
7383,0,0,1,0,0,0,0,1
7384,0,0,1,0,0,0,0,1
7388,0,0,1,0,0,0,0,1
7389,1,0,0,0,0,0,0,1
7402,1,0,0,0,0,0,0,1
7405,2,0,0,0,0,0,0,2
7409,0,0,1,0,0,0,0,1
7412,2,0,0,0,0,0,0,2
7417,1,0,0,0,0,0,0,1
7424,1,0,0,0,0,0,0,1
7440,1,0,0,0,0,0,0,1
7443,2,0,0,0,0,0,0,2
7445,1,0,0,0,0,0,0,1
7451,1,0,0,0,0,0,0,1
7453,1,0,0,0,0,0,0,1
7457,2,0,0,0,0,0,0,2
7464,1,0,0,0,0,0,0,1
7465,2,0,0,0,0,0,0,2
7466,2,0,1,0,0,0,0,3
7478,0,0,1,0,0,0,0,1
7479,1,0,0,0,0,0,0,1
7489,0,0,1,0,0,0,0,1
7490,1,0,0,0,0,0,0,1
7493,1,0,0,0,0,0,0,1
7497,1,0,0,0,0,0,0,1
7500,0,0,1,0,0,0,0,1
7502,1,0,0,0,0,0,0,1
7503,0,0,1,0,0,0,0,1
7507,2,0,0,0,0,0,0,2
7510,1,0,0,0,0,0,0,1
7520,1,0,0,0,0,0,0,1
7521,1,0,0,0,0,0,0,1
7525,1,0,0,0,0,0,0,1
7528,1,0,0,0,0,1,0,2
7539,1,0,0,0,0,0,0,1
7541,1,0,0,0,0,0,0,1
7543,1,0,0,0,0,0,0,1
7554,0,1,0,0,0,0,0,1
7560,0,0,2,0,0,0,0,2
7564,1,0,0,0,0,0,0,1
7570,1,0,0,0,0,0,0,1
7572,0,1,0,0,0,0,0,1
7575,1,0,0,0,0,0,0,1
7583,0,0,1,0,0,0,0,1
7587,1,0,0,0,0,0,0,1
7589,8,0,1,0,0,0,0,9
7594,1,0,0,0,0,0,0,1
7597,1,0,0,0,0,0,0,1
7600,1,0,0,0,0,0,0,1
7602,1,0,0,0,0,0,0,1
7603,1,0,0,0,0,0,0,1
7604,1,0,0,0,0,0,0,1
7606,1,0,0,0,0,0,0,1
7630,2,1,0,0,0,0,0,3
7636,1,0,0,0,0,0,0,1
7637,0,0,1,0,0,0,0,1
7644,0,0,1,0,0,0,0,1
7646,1,0,0,0,0,0,0,1
7650,2,0,1,1,0,0,0,4
7651,1,0,0,0,0,0,0,1
7655,1,0,0,0,0,0,0,1
7656,2,0,0,0,0,0,0,2
7660,1,0,0,0,0,0,0,1
7670,2,0,0,0,0,0,0,2
7680,1,0,0,0,0,0,0,1
7683,1,0,0,0,0,0,0,1
7687,1,0,0,0,0,0,0,1
7689,1,0,0,0,0,0,0,1
7696,0,1,0,0,0,0,0,1
7697,1,0,1,0,0,0,0,2
7699,1,0,0,0,0,0,0,1
7700,3,3,0,2,0,0,0,8
7711,5,0,0,0,0,1,0,6
7718,2,0,0,0,0,0,0,2
7720,1,0,1,0,0,0,0,2
7733,1,0,0,0,0,0,0,1
7740,0,0,1,0,0,0,0,1
7741,0,1,0,0,0,0,0,1
7744,1,0,0,0,0,0,0,1
7758,0,0,1,0,0,0,0,1
7763,0,0,1,0,0,0,0,1
7769,1,0,0,0,0,0,0,1
7772,5,0,0,0,0,0,0,5
7789,1,0,0,0,0,0,0,1
7791,1,0,0,0,0,0,0,1
7794,1,0,0,0,0,0,0,1
7799,2,0,0,0,0,0,0,2
7804,1,0,0,0,0,0,0,1
7806,1,0,0,0,0,0,0,1
7818,1,0,0,0,0,0,0,1
7821,1,0,0,0,0,0,0,1
7828,1,0,0,0,0,0,0,1
7834,3,0,1,0,0,0,0,4
7837,1,0,0,0,0,0,0,1
7839,1,0,0,0,0,0,0,1
7844,1,0,0,0,0,0,0,1
7850,1,0,0,0,0,0,0,1
7851,2,0,0,0,0,0,0,2
7854,1,0,0,0,0,0,0,1
7861,1,0,0,0,0,0,0,1
7868,1,0,0,0,0,0,0,1
7872,1,0,0,0,0,0,0,1
7876,0,1,0,0,0,0,0,1
7877,1,0,0,0,0,0,0,1
7881,0,0,0,0,0,1,0,1
7884,1,0,0,0,0,0,0,1
7892,0,0,0,1,0,0,0,1
7896,1,0,0,0,0,0,0,1
7907,2,0,0,0,0,0,0,2
7910,0,0,1,0,0,0,0,1
7915,1,0,0,0,0,0,0,1
7920,1,0,0,0,0,0,0,1
7930,2,0,0,0,0,0,0,2
7934,0,0,1,0,0,0,0,1
7935,2,0,0,0,0,0,0,2
7938,1,0,0,0,0,0,0,1
7942,1,0,0,0,0,0,0,1
7945,1,0,0,0,0,0,0,1
7950,1,0,0,0,0,0,0,1
7956,1,1,2,0,0,0,0,4
7957,1,0,0,0,0,0,0,1
7968,0,0,1,0,0,0,0,1
7969,1,0,0,0,0,0,0,1
7972,1,0,0,0,0,0,0,1
7974,1,0,0,0,0,0,0,1
7975,1,0,0,0,0,0,0,1
7976,1,0,0,0,0,0,0,1
7980,0,0,0,0,0,1,0,1
7987,0,0,1,0,0,0,0,1
7997,2,0,0,0,0,0,0,2
8017,1,0,1,0,0,0,0,2
8020,0,0,1,0,0,0,0,1
8026,1,0,0,0,0,0,0,1
8039,1,0,0,0,0,0,0,1
8040,1,0,1,0,0,1,0,3
8041,0,0,1,0,0,0,0,1
8044,1,0,0,0,0,0,0,1
8045,1,0,0,0,0,0,0,1
8050,2,0,0,0,0,1,0,3
8056,1,0,0,0,0,0,0,1
8062,2,0,0,0,0,0,0,2
8075,0,1,0,0,0,0,0,1
8076,1,0,0,0,0,0,0,1
8078,3,0,2,0,0,0,0,5
8083,1,0,0,0,0,0,0,1
8084,1,0,0,0,0,0,0,1
8085,1,0,0,0,0,0,0,1
8095,0,0,1,0,0,0,0,1
8099,1,0,0,0,0,0,0,1
8106,1,0,0,0,0,0,0,1
8111,1,0,0,0,0,0,0,1
8116,1,0,0,0,0,0,0,1
8121,0,0,1,0,0,0,0,1
8123,1,0,0,0,0,0,0,1
8125,0,0,1,0,0,0,0,1
8140,2,1,0,0,0,0,0,3
8142,1,1,0,0,0,0,0,2
8143,0,0,1,0,0,0,0,1
8152,1,0,0,0,0,0,0,1
8160,0,0,0,1,0,0,0,1
8170,1,0,0,0,0,0,0,1
8181,1,0,0,0,0,0,0,1
8184,0,0,1,0,0,0,0,1
8189,1,0,0,0,0,0,0,1
8192,1,0,0,0,0,0,0,1
8195,0,0,1,0,0,0,0,1
8198,1,0,0,0,0,0,0,1
8200,1,0,1,1,0,0,0,3
8201,1,0,0,0,0,0,0,1
8211,1,0,0,0,0,0,0,1
8229,1,0,0,0,0,0,0,1
8238,1,0,0,0,0,0,0,1
8239,1,0,0,0,0,0,0,1
8263,1,0,0,0,0,0,0,1
8280,2,0,0,0,0,0,0,2
8282,0,0,1,0,0,0,0,1
8284,1,0,0,0,0,0,0,1
8296,1,0,0,0,0,0,0,1
8313,0,0,1,0,0,0,0,1
8317,1,0,0,0,0,0,0,1
8320,0,0,1,0,0,0,0,1
8323,5,0,0,0,0,0,0,5
8324,1,0,0,0,0,0,0,1
8325,0,0,1,0,0,0,0,1
8329,1,0,0,0,0,0,0,1
8332,0,0,1,0,0,0,0,1
8333,1,0,0,0,0,0,0,1
8336,1,0,0,0,0,0,0,1
8341,1,0,1,0,0,1,0,3
8345,1,0,0,0,0,0,0,1
8355,0,0,1,0,0,0,0,1
8372,1,0,0,0,0,0,0,1
8384,0,1,0,0,0,0,0,1
8386,1,0,0,0,0,0,0,1
8392,0,0,1,0,0,0,0,1
8396,1,0,0,0,0,0,0,1
8397,1,0,0,0,0,0,0,1
8400,2,0,2,0,0,1,0,5
8409,1,0,0,0,0,0,0,1
8415,1,0,0,0,0,0,0,1
8424,2,0,0,0,0,0,0,2
8425,0,1,0,0,0,0,0,1
8439,1,0,0,0,0,0,0,1
8444,1,0,0,0,0,0,0,1
8445,0,0,0,1,0,0,0,1
8446,3,0,0,0,0,0,0,3
8453,0,1,0,0,0,0,0,1
8455,1,0,0,0,0,0,0,1
8477,1,0,0,0,0,0,0,1
8481,0,0,1,0,0,0,0,1
8483,1,0,0,0,0,0,0,1
8486,2,0,0,0,0,0,0,2
8498,1,0,0,0,0,0,0,1
8507,0,1,0,0,0,0,0,1
8509,1,0,0,0,0,0,0,1
8511,1,0,0,0,0,0,0,1
8514,1,0,0,0,0,0,0,1
8516,2,0,0,0,0,0,0,2
8520,0,0,0,0,0,1,0,1
8525,1,0,0,0,0,0,0,1
8526,1,0,0,0,0,0,0,1
8529,1,0,0,0,0,0,0,1
8533,1,0,0,0,0,0,0,1
8544,1,0,0,0,0,0,0,1
8550,1,0,0,0,0,0,0,1
8551,1,0,0,0,0,0,0,1
8555,0,0,1,0,0,0,0,1
8560,1,0,0,0,0,0,0,1
8567,1,0,1,0,0,0,0,2
8568,4,1,1,0,0,0,0,6
8570,1,0,0,0,0,0,0,1
8577,1,0,0,0,0,0,0,1
8579,1,0,0,0,0,0,0,1
8583,1,0,0,0,0,0,0,1
8586,1,0,0,0,0,0,0,1
8593,1,0,0,0,0,0,0,1
8603,0,0,1,0,0,0,0,1
8616,0,0,2,0,0,0,0,2
8617,1,0,0,0,0,0,0,1
8619,1,0,0,0,0,0,0,1
8629,1,0,0,0,0,0,0,1
8631,1,0,0,0,0,0,0,1
8636,0,0,1,0,0,0,0,1
8638,1,0,0,0,0,0,0,1
8640,1,0,0,0,0,1,0,2
8642,1,0,0,0,0,0,0,1
8646,0,0,1,0,0,0,0,1
8650,0,0,1,1,0,0,0,2
8651,0,0,0,1,0,0,0,1
8661,0,0,1,0,0,0,0,1
8663,1,0,0,0,0,0,0,1
8677,0,0,1,0,0,0,0,1
8683,0,0,1,0,0,0,0,1
8690,1,0,2,0,0,0,0,3
8697,1,0,0,0,0,0,0,1
8698,1,0,0,0,0,0,0,1
8700,1,0,0,0,0,0,0,1
8704,1,0,0,0,0,0,0,1
8708,1,0,0,0,0,0,0,1
8709,1,0,0,0,0,0,0,1
8720,1,0,0,0,0,0,0,1
8722,0,1,0,0,0,0,0,1
8724,1,0,0,0,0,0,0,1
8731,0,0,1,0,0,0,0,1
8734,1,0,0,0,0,0,0,1
8737,1,0,0,0,0,0,0,1
8739,0,1,0,0,0,0,0,1
8741,1,0,0,0,0,0,0,1
8744,0,0,1,0,0,0,0,1
8746,0,0,1,0,0,0,0,1
8750,1,1,0,0,0,0,0,2
8752,1,0,0,0,0,0,0,1
8769,0,1,0,0,0,0,0,1
8778,1,0,0,0,0,0,0,1
8779,1,0,0,0,0,0,0,1
8792,1,0,0,0,0,0,0,1
8793,1,0,0,0,0,0,0,1
8800,0,1,0,0,0,0,0,1
8802,2,0,0,0,0,0,0,2
8805,0,0,0,0,0,1,0,1
8807,0,0,0,0,0,0,1,1
8809,1,0,0,0,0,0,0,1
8811,0,1,1,0,0,0,0,2
8813,3,0,2,1,0,0,0,6
8820,1,0,0,0,0,0,0,1
8821,0,0,1,0,0,0,0,1
8822,1,0,0,0,0,0,0,1
8827,1,0,1,0,0,0,0,2
8837,1,0,0,0,0,0,0,1
8838,1,0,0,0,0,0,0,1
8839,0,0,1,0,0,0,0,1
8846,1,0,0,0,0,0,0,1
8850,1,0,0,0,0,0,0,1
8852,0,1,0,0,0,0,0,1
8863,0,0,0,1,0,0,0,1
8865,1,0,0,0,0,0,0,1
8874,1,0,0,0,0,0,0,1
8878,1,0,0,0,0,0,0,1
8880,1,0,0,0,0,0,0,1
8882,1,0,0,0,0,0,0,1
8884,1,0,0,0,0,0,0,1
8886,1,0,0,0,0,0,0,1
8891,1,0,0,0,0,0,0,1
8894,1,1,1,0,0,0,0,3
8895,0,0,0,1,0,0,0,1
8898,0,0,1,0,0,0,0,1
8900,0,0,1,0,0,0,0,1
8902,1,0,0,0,0,0,0,1
8919,1,0,0,0,0,0,0,1
8923,0,0,1,0,0,0,0,1
8926,0,0,1,0,0,0,0,1
8933,1,0,0,0,0,0,0,1
8935,2,0,1,0,0,0,0,3
8942,0,1,0,0,0,0,0,1
8944,1,0,0,0,0,0,0,1
8947,1,0,0,0,0,0,0,1
8955,2,0,0,0,0,0,0,2
8969,2,0,0,0,0,0,0,2
8976,1,0,0,0,0,0,0,1
8981,1,1,0,0,0,0,0,2
8990,2,0,0,0,0,0,0,2
8997,1,0,0,0,0,0,0,1
9011,1,0,0,0,0,0,0,1
9017,1,0,0,0,0,0,0,1
9020,0,0,1,0,0,0,0,1
9026,1,0,0,0,0,0,0,1
9040,1,0,0,0,0,0,0,1
9053,1,0,0,0,0,0,0,1
9058,4,0,2,0,0,0,0,6
9064,1,0,0,0,0,0,0,1
9098,1,0,0,0,0,0,0,1
9104,3,0,0,0,0,0,0,3
9109,1,0,0,0,0,0,0,1
9119,1,0,1,0,0,0,0,2
9127,1,0,0,0,0,0,0,1
9137,1,0,0,0,0,0,0,1
9139,2,0,1,0,0,0,0,3
9145,1,0,0,0,0,0,0,1
9168,1,0,0,0,0,0,0,1
9177,1,0,0,0,0,0,0,1
9180,3,0,0,0,0,1,0,4
9183,1,0,0,0,0,0,0,1
9186,1,0,0,0,0,0,0,1
9187,1,0,0,0,0,0,0,1
9190,1,0,0,0,0,0,0,1
9192,0,0,1,0,0,0,0,1
9203,1,0,0,0,0,0,0,1
9221,0,0,1,0,0,0,0,1
9222,1,0,0,0,0,0,0,1
9229,0,0,1,0,0,0,0,1
9232,0,0,0,0,0,1,0,1
9240,3,0,0,0,0,0,0,3
9241,0,1,0,0,0,0,0,1
9244,0,0,1,0,0,0,0,1
9275,1,0,0,0,0,0,0,1
9299,1,0,0,0,0,0,0,1
9301,1,0,0,0,0,0,0,1
9302,3,0,0,0,0,0,0,3
9306,0,1,0,0,0,0,0,1
9321,0,0,1,0,0,0,0,1
9324,0,0,1,0,0,0,0,1
9331,1,0,0,0,0,0,0,1
9339,0,0,1,0,0,0,0,1
9351,1,0,0,0,0,0,0,1
9354,1,0,0,0,0,0,0,1
9357,1,0,0,0,0,0,0,1
9382,0,1,0,0,0,0,0,1
9384,1,0,1,0,0,0,0,2
9403,1,0,0,0,0,0,0,1
9407,0,1,0,0,0,0,0,1
9425,2,0,0,1,0,0,0,3
9427,1,0,0,0,0,0,0,1
9432,1,0,0,0,0,0,0,1
9443,1,0,0,0,0,0,0,1
9455,0,1,0,0,0,0,0,1
9456,1,0,0,0,0,0,0,1
9466,1,1,0,0,0,0,0,2
9470,1,0,0,0,0,0,0,1
9480,1,0,0,0,0,0,0,1
9498,0,0,0,1,0,0,0,1
9500,1,0,0,0,0,0,0,1
9503,1,0,0,0,0,0,0,1
9506,1,0,0,0,0,0,0,1
9517,1,0,0,0,0,0,0,1
9540,0,0,0,0,0,1,0,1
9545,0,0,1,0,0,0,0,1
9547,4,0,1,0,0,1,0,6
9550,0,0,1,0,0,0,0,1
9562,1,0,0,0,0,0,0,1
9568,1,0,0,0,0,0,0,1
9570,1,0,0,0,0,0,0,1
9574,1,0,0,0,0,0,0,1
9579,1,0,0,0,0,0,0,1
9599,1,0,0,0,0,0,0,1
9600,1,0,1,0,0,0,0,2
9602,2,0,0,0,0,0,0,2
9608,1,0,0,0,0,0,0,1
9611,1,0,0,0,0,0,0,1
9616,0,1,0,0,0,0,0,1
9625,1,0,0,0,0,0,0,1
9629,0,0,0,1,0,0,0,1
9650,1,0,0,0,0,0,0,1
9652,1,0,0,0,0,0,0,1
9668,1,0,0,0,0,0,0,1
9669,0,0,0,1,0,0,0,1
9670,4,0,1,0,0,0,0,5
9672,1,0,0,0,0,0,0,1
9690,1,0,0,0,0,0,0,1
9692,0,0,1,0,0,0,0,1
9706,1,0,0,0,0,0,0,1
9710,2,0,0,0,0,0,0,2
9714,1,0,1,0,0,0,0,2
9719,0,0,1,0,0,0,0,1
9720,1,0,0,0,0,0,0,1
9727,1,0,0,0,0,0,0,1
9731,2,0,0,0,0,0,0,2
9746,1,0,0,0,0,0,0,1
9760,0,0,0,0,0,1,0,1
9761,1,0,0,0,0,0,0,1
9772,0,0,1,0,0,0,0,1
9779,0,0,1,0,0,0,0,1
9780,1,0,0,0,0,0,0,1
9785,1,0,0,0,0,0,0,1
9792,2,0,0,0,0,0,0,2
9809,1,0,0,0,0,0,0,1
9813,0,0,1,0,0,0,0,1
9823,1,0,0,0,0,0,0,1
9828,0,0,1,0,0,0,0,1
9831,0,0,1,0,0,0,0,1
9839,1,0,0,0,0,0,0,1
9853,2,0,0,0,0,0,0,2
9855,1,0,0,0,0,0,0,1
9860,1,0,0,0,0,0,0,1
9862,1,0,0,0,0,0,0,1
9874,1,0,0,0,0,0,0,1
9878,0,0,1,0,0,0,0,1
9879,1,0,0,0,0,0,0,1
9904,1,0,0,0,0,0,0,1
9912,0,0,1,0,0,0,0,1
9913,2,0,0,0,0,0,0,2
9914,0,0,0,0,0,1,0,1
9928,1,0,0,0,0,0,0,1
9935,1,0,0,0,0,0,0,1
9945,1,0,0,0,0,0,0,1
9955,3,0,0,0,0,0,0,3
9963,1,0,0,0,0,0,0,1
9974,1,0,0,0,0,0,0,1
9975,1,0,0,0,0,0,0,1
9976,2,1,0,0,0,0,0,3
9990,1,0,0,0,0,0,0,1
9996,1,0,0,0,0,0,0,1
10000,1,0,1,0,0,0,0,2
10005,0,0,0,0,0,1,0,1
10017,1,0,0,0,0,0,0,1
10024,1,0,0,0,0,0,0,1
10034,1,0,0,0,0,0,0,1
10037,2,0,2,1,0,0,0,5
10055,1,0,0,0,0,0,0,1
10060,0,1,0,0,0,0,0,1
10065,0,0,1,0,0,0,0,1
10080,1,0,0,0,0,0,0,1
10084,0,0,0,0,0,1,0,1
10098,1,0,0,0,0,0,0,1
10115,0,0,1,0,0,0,0,1
10118,0,0,1,0,0,0,0,1
10149,1,0,0,0,0,0,0,1
10150,0,0,0,0,0,1,0,1
10157,1,0,0,0,0,0,0,1
10159,3,0,0,1,0,0,0,4
10161,1,0,0,0,0,0,0,1
10162,1,0,0,0,0,0,0,1
10169,1,0,0,0,0,0,0,1
10188,0,0,1,0,0,0,0,1
10196,1,0,0,0,0,0,0,1
10198,1,0,0,0,0,0,0,1
10200,3,1,1,0,0,0,0,5
10207,1,0,0,0,0,0,0,1
10220,1,1,0,0,0,0,0,2
10221,0,0,0,1,0,0,0,1
10240,0,0,1,0,0,0,0,1
10244,2,0,0,0,0,0,0,2
10259,1,0,0,0,0,0,0,1
10282,7,0,1,1,0,0,0,9
10294,1,0,0,0,0,0,0,1
10316,1,0,0,0,0,0,0,1
10318,0,0,1,0,0,0,0,1
10322,0,0,1,0,0,0,0,1
10325,1,0,0,0,0,0,0,1
10356,0,0,0,1,0,0,0,1
10363,0,0,2,0,0,0,0,2
10368,1,0,0,0,0,0,0,1
10370,1,0,0,0,0,0,0,1
10375,0,1,0,0,0,0,0,1
10389,1,0,0,0,0,0,0,1
10400,1,0,0,0,0,0,0,1
10403,0,0,0,1,0,0,0,1
10404,2,0,3,0,0,0,0,5
10425,1,0,0,0,0,0,0,1
10440,1,0,0,0,0,1,0,2
10445,1,0,0,0,0,0,0,1
10472,0,0,1,0,0,0,0,1
10485,0,0,0,1,0,0,0,1
10497,1,0,0,0,0,0,0,1
10500,2,0,1,0,0,0,0,3
10526,1,0,1,0,0,0,0,2
10528,1,0,0,0,0,0,0,1
10536,1,0,0,0,0,0,0,1
10543,0,0,0,1,0,0,0,1
10555,1,0,0,0,0,0,0,1
10567,0,1,0,0,0,0,0,1
10588,0,1,0,0,0,0,0,1
10597,1,0,0,0,0,1,0,2
10608,1,0,0,0,0,0,0,1
10615,0,1,0,0,0,0,0,1
10619,1,0,0,0,0,0,0,1
10624,1,0,1,0,0,0,0,2
10628,1,0,0,0,0,0,0,1
10643,2,0,0,0,0,0,0,2
10648,0,0,0,1,0,0,0,1
10649,5,0,1,0,0,0,0,6
10655,1,0,0,0,0,0,0,1
10663,1,0,0,0,0,0,0,1
10680,1,0,2,0,0,0,0,3
10690,0,0,1,0,0,0,0,1
10705,1,0,0,0,0,0,0,1
10710,1,0,0,0,0,0,0,1
10718,0,0,0,1,0,0,0,1
10738,1,0,0,0,0,0,0,1
10740,0,0,1,1,0,1,0,3
10769,0,1,0,0,0,0,0,1
10771,3,0,3,1,0,0,0,7
10785,0,0,0,1,0,0,0,1
10791,1,0,0,0,0,0,0,1
10796,0,0,0,1,0,0,0,1
10812,1,0,0,0,0,0,0,1
10822,0,0,1,0,0,0,0,1
10850,0,1,0,0,0,0,0,1
10853,0,0,1,0,0,0,0,1
10863,1,0,0,0,0,0,0,1
10875,1,0,0,0,0,0,0,1
10876,1,0,0,0,0,0,0,1
10888,0,0,1,0,0,0,0,1
10894,2,1,1,0,0,0,0,4
10920,1,0,0,1,0,0,0,2
10933,1,0,0,0,0,0,0,1
10934,1,0,0,0,0,0,0,1
10954,0,0,0,1,0,0,0,1
10971,1,0,0,0,0,0,0,1
11016,3,1,1,0,0,0,0,5
11026,1,0,0,0,0,0,0,1
11040,1,0,2,0,0,0,0,3
11056,0,1,0,0,0,0,0,1
11082,0,0,0,0,0,0,1,1
11089,1,0,0,0,0,0,0,1
11134,1,0,0,0,0,0,0,1
11138,2,0,1,0,0,0,0,3
11149,1,0,0,0,0,0,0,1
11160,1,0,0,2,0,0,0,3
11172,0,1,0,0,0,0,0,1
11179,3,0,0,0,0,0,0,3
11181,1,0,0,0,0,0,0,1
11182,1,0,0,0,0,0,0,1
11183,1,0,0,0,0,0,0,1
11187,0,0,1,0,0,0,0,1
11200,2,0,0,0,0,0,0,2
11232,1,0,0,0,0,0,0,1
11243,1,0,0,0,0,0,0,1
11261,7,0,0,0,0,0,0,7
11280,0,0,1,0,0,0,0,1
11284,1,0,0,0,0,0,0,1
11330,1,0,0,0,0,0,0,1
11339,0,0,1,0,0,0,0,1
11340,1,0,0,0,0,0,0,1
11375,0,0,1,0,0,0,0,1
11383,0,1,1,0,0,0,0,2
11384,0,0,0,1,0,0,0,1
11398,0,0,0,1,0,0,0,1
11420,1,0,0,0,0,0,0,1
11444,1,0,0,0,0,0,0,1
11460,0,0,0,1,0,0,0,1
11465,1,0,0,0,0,0,0,1
11472,0,1,0,0,0,0,0,1
11474,1,0,0,0,0,0,0,1
11488,1,0,0,0,0,0,0,1
11506,1,0,1,2,0,0,0,4
11520,1,0,0,0,0,0,0,1
11580,0,0,0,0,0,1,0,1
11583,0,1,0,0,0,0,0,1
11587,1,0,0,0,0,0,0,1
11600,2,0,0,0,0,0,0,2
11628,0,0,0,1,0,0,0,1
11640,2,0,0,0,0,0,0,2
11641,2,0,0,0,0,0,0,2
11652,0,1,0,0,0,0,0,1
11673,1,0,0,0,0,0,0,1
11678,0,0,0,1,0,0,0,1
11686,1,0,0,0,0,0,0,1
11689,1,0,0,0,0,0,0,1
11733,1,0,0,0,0,0,0,1
11741,0,0,1,0,0,0,0,1
11750,4,0,0,0,0,0,0,4
11760,2,0,0,0,0,0,0,2
11779,1,0,0,0,0,0,0,1
11798,1,0,0,0,0,0,0,1
11803,1,0,0,0,0,0,0,1
11812,1,0,1,0,0,0,0,2
11827,0,0,1,0,0,0,0,1
11832,1,0,0,0,0,0,0,1
11856,1,0,0,0,0,0,0,1
11862,1,0,0,0,0,0,0,1
11868,1,0,0,0,0,0,0,1
11873,4,0,1,0,0,0,0,5
11878,1,0,0,0,0,0,0,1
11880,2,0,0,0,0,0,0,2
11891,0,0,0,1,0,0,0,1
11894,1,0,0,0,0,0,0,1
11899,1,0,0,0,0,0,0,1
11914,1,0,0,0,0,0,0,1
11920,0,0,1,0,0,0,0,1
11931,1,0,0,0,0,0,0,1
11934,0,0,0,1,0,0,0,1
11947,1,0,0,0,0,0,0,1
11949,0,0,1,0,0,0,0,1
11954,0,0,0,1,0,0,0,1
11968,0,0,0,1,0,0,0,1
11971,1,0,1,0,0,0,0,2
11995,5,0,1,1,0,0,0,7
12000,0,0,1,0,0,0,0,1
12007,1,0,0,0,0,0,0,1
12019,1,0,0,0,0,0,0,1
12025,0,0,1,0,0,0,0,1
12041,1,0,0,0,0,0,0,1
12044,1,0,0,0,0,0,0,1
12053,1,0,0,0,0,0,0,1
12068,0,0,0,1,0,0,0,1
12075,0,0,1,0,0,0,0,1
12109,1,0,0,0,0,0,0,1
12115,1,0,0,0,0,0,0,1
12118,4,0,1,0,0,0,0,5
12130,0,1,0,0,0,0,0,1
12149,1,0,0,0,0,0,0,1
12155,1,0,0,0,0,0,0,1
12158,0,0,0,1,0,0,0,1
12193,1,0,0,0,0,0,0,1
12211,0,0,1,0,0,0,0,1
12223,1,0,0,0,0,0,0,1
12229,1,0,0,0,0,0,0,1
12240,6,1,0,1,0,0,0,8
12242,1,0,0,0,0,0,0,1
12250,2,1,2,0,0,0,0,5
12271,0,0,0,1,0,0,0,1
12287,0,0,1,0,0,0,0,1
12300,2,0,0,0,0,0,0,2
12305,1,0,0,0,0,0,0,1
12320,1,0,0,0,0,0,0,1
12322,1,0,0,0,0,0,0,1
12323,0,1,0,0,0,0,0,1
12346,1,0,0,0,0,0,0,1
12362,2,0,0,0,0,0,0,2
12363,0,0,0,2,0,0,0,2
12379,0,0,1,0,0,0,0,1
12390,0,1,0,0,0,0,0,1
12392,1,0,0,0,0,0,0,1
12403,1,0,1,1,0,0,0,3
12438,1,0,0,0,0,0,0,1
12439,1,0,0,0,0,0,0,1
12450,0,1,0,0,0,0,0,1
12480,1,0,0,0,0,0,0,1
12485,5,0,0,0,0,0,0,5
12497,1,0,0,0,0,0,0,1
12546,2,0,0,0,0,0,0,2
12560,1,0,0,0,0,0,0,1
12566,1,0,1,0,0,0,0,2
12575,1,0,0,0,0,0,0,1
12582,1,0,0,0,0,0,0,1
12586,0,0,1,0,0,0,0,1
12600,1,0,1,0,0,0,0,2
12607,3,0,0,0,0,0,0,3
12616,2,0,0,0,0,0,0,2
12628,1,0,0,0,0,0,0,1
12632,2,0,0,0,0,0,0,2
12640,1,0,0,0,0,0,0,1
12648,1,0,0,0,0,0,0,1
12667,0,0,0,1,0,0,0,1
12675,0,0,1,0,0,0,0,1
12695,1,0,0,0,0,0,0,1
12718,0,0,1,0,0,0,0,1
12720,0,0,1,0,0,0,0,1
12730,1,0,2,0,0,0,0,3
12759,1,0,0,0,0,0,0,1
12774,0,1,0,0,0,0,0,1
12780,0,0,1,0,0,0,0,1
12781,1,0,0,0,0,0,0,1
12783,1,0,0,0,0,0,0,1
12811,0,0,1,0,0,0,0,1
12828,1,0,0,0,0,0,0,1
12844,0,0,1,0,0,0,0,1
12852,2,0,0,0,0,0,0,2
12857,1,0,0,0,0,0,0,1
12863,1,0,0,0,0,0,0,1
12893,0,0,1,0,0,0,0,1
12909,1,0,0,0,0,0,0,1
12924,1,0,0,0,0,0,0,1
12945,1,0,0,0,0,0,0,1
12974,3,0,1,0,0,0,0,4
13015,0,0,0,1,0,0,0,1
13035,0,0,0,1,0,0,0,1
13036,1,0,0,0,0,0,0,1
13056,1,0,1,0,0,0,0,2
13065,1,0,0,0,0,0,0,1
13096,0,0,0,1,0,0,0,1
13097,1,0,2,2,0,0,0,5
13099,1,0,0,0,0,0,0,1
13120,1,0,0,0,0,0,0,1
13126,0,1,0,0,0,0,0,1
13138,2,0,0,0,0,0,0,2
13158,0,0,0,1,0,0,0,1
13159,0,0,0,1,0,0,0,1
13213,1,0,0,0,0,0,0,1
13218,1,0,0,0,0,0,0,1
13219,2,0,2,0,0,0,0,4
13231,1,0,0,0,0,0,0,1
13280,1,0,0,0,0,0,0,1
13281,0,0,0,1,0,0,0,1
13295,1,0,0,0,0,0,0,1
13300,0,0,1,1,0,0,0,2
13301,1,0,0,0,0,0,0,1
13311,1,0,0,0,0,0,0,1
13320,1,0,0,0,0,0,0,1
13342,3,0,2,0,0,0,0,5
13345,1,0,0,0,0,0,0,1
13358,0,0,1,0,0,0,0,1
13360,0,0,0,1,0,0,0,1
13370,0,1,0,0,0,0,0,1
13382,1,0,1,0,0,0,0,2
13410,0,1,0,0,0,0,0,1
13412,1,0,0,0,0,0,0,1
13421,0,0,1,0,0,0,0,1
13427,1,0,0,0,0,0,0,1
13433,1,0,1,0,0,0,0,2
13434,1,0,0,0,0,0,0,1
13464,2,1,0,0,0,0,0,3
13469,0,0,1,0,0,0,0,1
13500,0,0,0,0,0,1,0,1
13505,0,0,1,0,0,0,0,1
13523,1,0,0,0,0,0,0,1
13532,0,0,0,1,0,0,0,1
13572,1,0,0,0,0,0,0,1
13586,4,0,0,0,0,0,0,4
13620,1,0,0,0,0,0,0,1
13626,1,0,0,0,0,0,0,1
13635,1,0,0,0,0,0,0,1
13648,1,0,0,1,0,0,0,2
13695,1,0,0,0,0,0,0,1
13709,2,0,0,0,0,0,0,2
13721,0,1,0,0,0,0,0,1
13754,0,0,0,1,0,0,0,1
13760,1,0,0,0,0,0,0,1
13830,1,0,0,0,0,0,0,1
13831,0,0,2,1,0,0,0,3
13872,1,0,0,0,0,0,0,1
13910,1,0,0,0,0,0,0,1
13920,1,0,0,0,0,0,0,1
13954,2,0,0,0,0,0,0,2
13957,1,0,0,0,0,0,0,1
13984,1,0,0,0,0,0,0,1
13993,0,0,0,1,0,0,0,1
14000,1,0,0,0,0,0,0,1
14012,0,0,1,0,0,0,0,1
14016,0,0,0,1,0,0,0,1
14019,0,1,0,0,0,0,0,1
14035,1,0,0,0,0,0,0,1
14040,4,0,0,0,0,0,0,4
14048,0,0,0,1,0,0,0,1
14071,1,0,0,0,0,0,0,1
14076,1,0,0,0,0,0,0,1
14080,1,0,0,0,0,0,0,1
14093,0,0,0,1,0,0,0,1
14120,1,0,0,0,0,0,0,1
14121,0,0,1,0,0,0,0,1
14139,1,0,0,0,0,0,0,1
14198,3,0,1,0,0,0,0,4
14200,0,0,0,1,0,0,0,1
14201,1,0,0,0,0,0,0,1
14234,0,0,1,0,0,0,0,1
14240,1,0,0,0,0,0,0,1
14258,1,0,0,0,0,0,0,1
14280,2,0,0,0,0,0,0,2
14281,0,0,0,1,0,0,0,1
14286,0,0,1,0,0,0,0,1
14298,1,0,0,0,0,0,0,1
14320,0,0,0,1,0,0,0,1
14321,0,0,0,1,0,0,0,1
14350,0,0,1,0,0,0,0,1
14362,0,0,1,0,0,0,0,1
14400,1,0,0,0,0,0,0,1
14417,1,0,0,0,0,0,0,1
14437,1,0,0,0,0,0,0,1
14443,4,0,0,1,0,0,0,5
14444,0,0,0,1,0,0,0,1
14454,1,0,0,0,0,0,0,1
14482,1,0,0,0,0,0,0,1
14483,1,0,0,0,0,0,0,1
14484,1,0,0,0,0,0,0,1
14487,0,0,0,1,0,0,0,1
14524,0,0,0,1,0,0,0,1
14565,0,0,0,1,0,0,0,1
14566,0,0,2,0,0,0,0,2
14607,0,0,0,1,0,0,0,1
14627,0,0,1,0,0,0,0,1
14640,0,1,0,1,0,0,0,2
14641,1,0,0,0,0,0,0,1
14687,0,0,0,1,0,0,0,1
14688,2,0,0,0,0,0,0,2
14700,1,0,0,1,0,0,0,2
14734,1,0,0,0,0,0,0,1
14748,0,0,0,1,0,0,0,1
14751,1,0,0,0,0,0,0,1
14810,1,0,0,0,0,0,0,1
14820,0,0,1,0,0,0,0,1
14829,0,0,1,0,0,0,0,1
14835,0,0,1,0,0,0,0,1
14851,0,0,1,0,0,0,0,1
14864,1,0,0,0,0,0,0,1
14880,1,0,1,0,0,0,0,2
14902,0,0,1,0,0,0,0,1
14904,0,0,1,0,0,0,0,1
14933,0,1,1,2,0,0,0,4
14934,1,0,0,0,0,0,0,1
14973,0,0,1,0,0,0,0,1
14978,1,0,0,0,0,0,0,1
14986,0,0,1,0,0,0,0,1
15014,1,0,0,0,0,0,0,1
15015,0,0,0,1,0,0,0,1
15034,0,0,1,0,0,0,0,1
15048,0,0,1,0,0,0,0,1
15055,1,0,0,0,0,0,0,1
15068,1,0,0,0,0,0,0,1
15096,1,1,0,0,0,0,0,2
15116,0,0,1,0,0,0,0,1
15120,2,0,0,0,0,0,0,2
15178,2,0,2,1,0,0,0,5
15212,1,0,1,0,0,0,0,2
15239,1,0,0,0,0,0,0,1
15252,1,0,0,0,0,0,0,1
15259,1,0,0,0,0,0,0,1
15300,3,0,0,0,0,0,0,3
15301,0,0,0,1,0,0,0,1
15386,1,0,0,0,0,0,0,1
15422,3,0,0,1,0,0,0,4
15504,1,0,0,0,0,0,0,1
15545,3,0,0,1,0,0,0,4
15605,1,0,0,0,0,0,0,1
15619,1,0,0,0,0,0,0,1
15627,0,0,0,1,0,0,0,1
15630,0,0,1,0,0,0,0,1
15645,1,0,0,0,0,0,0,1
15660,1,0,0,0,0,0,0,1
15667,3,0,1,1,0,0,0,5
15720,1,0,0,0,0,0,0,1
15728,0,1,0,0,0,0,0,1
15750,1,0,1,1,0,0,0,3
15790,1,0,0,0,0,0,0,1
15830,0,1,1,0,0,0,0,2
15851,1,0,0,0,0,0,0,1
15905,0,0,0,1,0,0,0,1
15911,0,0,0,1,0,0,0,1
15912,2,0,0,0,0,0,0,2
15925,0,0,1,0,0,0,0,1
15994,1,1,0,0,0,0,0,2
16013,1,0,0,0,0,0,0,1
16020,1,0,0,0,0,0,0,1
16034,1,0,0,0,0,0,0,1
16044,1,0,0,0,0,0,0,1
16048,1,0,0,0,0,0,0,1
16073,0,0,0,1,0,0,0,1
16075,0,0,1,0,0,0,0,1
16089,1,0,0,0,0,0,0,1
16096,0,0,1,0,0,0,0,1
16100,0,0,1,1,0,0,0,2
16157,2,0,3,0,0,0,0,5
16200,2,0,0,0,0,0,0,2
16218,2,0,0,0,0,0,0,2
16255,1,0,0,0,0,0,0,1
16279,1,1,0,0,0,0,0,2
16290,1,0,0,0,0,0,0,1
16320,1,0,0,0,0,0,0,1
16401,0,0,0,1,0,0,0,1
16402,1,0,0,0,0,0,0,1
16406,0,0,0,1,0,0,0,1
16452,1,0,0,0,0,0,0,1
16484,0,0,0,1,0,0,0,1
16511,0,1,0,0,0,0,0,1
16524,2,0,0,1,0,0,0,3
16560,0,1,0,0,0,0,0,1
16565,0,0,0,1,0,0,0,1
16566,1,0,0,0,0,0,0,1
16567,1,0,0,0,0,0,0,1
16646,1,0,1,0,0,0,0,2
16656,1,0,0,0,0,0,0,1
16680,0,0,0,1,0,0,0,1
16687,1,0,0,0,0,0,0,1
16710,1,0,0,0,0,0,0,1
16728,0,1,0,0,0,0,0,1
16733,0,0,1,0,0,0,0,1
16752,1,0,0,0,0,0,0,1
16762,1,0,0,0,0,0,0,1
16787,0,1,0,0,0,0,0,1
16800,1,0,1,0,0,0,0,2
16805,0,1,0,0,0,0,0,1
16852,1,0,0,0,0,0,0,1
16891,2,0,0,0,0,0,0,2
16896,1,0,0,0,0,0,0,1
16920,2,0,0,0,0,0,0,2
16934,0,0,0,1,0,0,0,1
16968,1,0,0,0,0,0,0,1
17012,0,0,0,1,0,0,0,1
17014,2,0,0,0,0,0,0,2
17030,0,0,0,1,0,0,0,1
17075,0,0,1,0,0,0,0,1
17085,0,0,0,1,0,0,0,1
17087,1,0,0,0,0,0,0,1
17136,3,0,0,0,0,0,0,3
17150,0,0,2,0,0,0,0,2
17183,0,0,0,1,0,0,0,1
17217,0,0,0,1,0,0,0,1
17258,1,0,0,0,0,0,0,1
17279,0,0,0,1,0,0,0,1
17280,0,1,0,0,0,0,0,1
17299,1,0,0,0,0,0,0,1
17301,1,0,0,0,0,0,0,1
17320,0,0,1,0,0,0,0,1
17366,0,0,0,1,0,0,0,1
17381,0,1,1,0,0,0,0,2
17421,0,0,0,1,0,0,0,1
17429,0,1,0,0,0,0,0,1
17435,1,0,0,0,0,0,0,1
17442,1,0,0,1,0,0,0,2
17460,1,0,0,0,0,0,0,1
17461,0,0,0,1,0,0,0,1
17462,0,1,0,0,0,0,0,1
17500,1,0,0,3,0,0,0,4
17503,3,0,0,1,0,0,0,4
17520,1,0,0,0,0,0,0,1
17544,1,0,0,1,0,0,0,2
17626,1,0,1,0,0,0,0,2
17640,0,0,0,1,0,0,0,1
17642,0,0,1,0,0,0,0,1
17686,0,0,0,1,0,0,0,1
17687,1,0,0,1,0,0,0,2
17707,1,0,0,0,0,0,0,1
17713,0,1,0,0,0,0,0,1
17736,0,0,1,0,0,0,0,1
17748,0,0,1,1,0,0,0,2
17789,1,0,0,0,0,0,0,1
17845,1,0,0,0,0,0,0,1
17850,0,0,2,0,0,0,0,2
17863,0,1,0,0,0,0,0,1
17871,0,0,0,2,0,0,0,2
17898,0,0,1,0,0,0,0,1
17917,1,0,0,0,0,0,0,1
17920,0,0,1,0,0,0,0,1
17931,0,0,0,1,0,0,0,1
17932,1,0,0,0,0,0,0,1
17950,1,0,0,0,0,0,0,1
17992,0,0,0,1,0,0,0,1
17993,1,0,0,0,0,0,0,1
18000,1,0,0,0,0,0,0,1
18014,1,0,0,0,0,0,0,1
18034,0,0,1,0,0,0,0,1
18064,0,1,0,0,0,0,0,1
18115,1,0,0,0,0,0,0,1
18176,0,0,1,0,0,0,0,1
18197,0,0,1,0,0,0,0,1
18220,1,0,0,0,0,0,0,1
18224,1,0,0,0,0,0,0,1
18237,0,0,0,1,0,0,0,1
18240,1,0,0,0,0,0,0,1
18299,1,0,0,0,0,0,0,1
18360,2,1,0,0,0,0,0,3
18437,1,0,0,0,0,0,0,1
18442,0,0,0,1,0,0,0,1
18523,1,0,0,0,0,0,0,1
18544,1,0,1,0,0,0,0,2
18600,1,0,1,0,0,0,0,2
18605,0,0,1,1,0,0,0,2
18673,1,0,0,0,0,0,0,1
18727,1,0,0,0,0,0,0,1
18732,0,0,0,1,0,0,0,1
18743,0,0,1,0,0,0,0,1
18757,0,0,0,1,0,0,0,1
18849,0,0,0,1,0,0,0,1
18850,1,0,1,0,0,0,0,2
18972,1,0,0,0,0,0,0,1
19013,1,0,0,0,0,0,0,1
19033,0,0,1,0,0,0,0,1
19094,2,0,1,0,0,0,0,3
19156,1,0,0,0,0,0,0,1
19216,0,0,0,2,0,0,0,2
19250,2,0,0,0,0,0,0,2
19260,1,0,0,0,0,0,0,1
19277,0,1,0,0,0,0,0,1
19278,0,0,1,0,0,0,0,1
19279,0,0,0,1,0,0,0,1
19283,1,0,0,0,0,0,0,1
19310,1,0,0,0,0,0,0,1
19339,4,0,0,0,0,0,0,4
19421,1,0,0,0,0,0,0,1
19438,0,1,0,0,0,0,0,1
19440,1,0,0,0,0,0,0,1
19462,0,0,1,0,0,0,0,1
19473,0,0,0,1,0,0,0,1
19503,0,0,0,1,0,0,0,1
19504,0,0,0,1,0,0,0,1
19523,1,0,1,0,0,0,0,2
19560,1,0,0,1,0,0,0,2
19584,1,1,0,0,0,0,0,2
19706,2,0,0,0,0,0,0,2
19707,0,0,0,1,0,0,0,1
19708,0,1,0,0,0,0,0,1
19747,0,0,0,1,0,0,0,1
19751,0,0,1,0,0,0,0,1
19797,1,0,0,0,0,0,0,1
19829,3,0,1,0,0,0,0,4
19886,1,0,0,0,0,0,0,1
19910,1,0,0,0,0,0,0,1
19951,1,0,0,0,0,0,0,1
20074,1,0,0,0,0,0,0,1
20135,0,0,0,1,0,0,0,1
20171,1,0,0,0,0,0,0,1
20196,0,0,1,0,0,0,0,1
20237,0,0,0,1,0,0,0,1
20240,1,0,0,0,0,0,0,1
20300,0,0,0,1,0,0,0,1
20318,0,1,0,0,0,0,0,1
20320,1,0,0,0,0,0,0,1
20380,1,0,1,0,0,0,0,2
20381,0,1,0,0,0,0,0,1
20441,0,1,1,1,0,0,0,3
20481,0,0,0,1,0,0,0,1
20485,0,1,0,0,0,0,0,1
20520,0,0,1,0,0,0,0,1
20563,1,0,0,1,0,0,0,2
20564,0,0,0,1,0,0,0,1
20624,0,0,1,1,0,0,0,2
20640,1,0,0,0,0,0,0,1
20685,1,0,0,0,0,0,0,1
20686,3,0,0,2,0,0,0,5
20807,0,0,0,1,0,0,0,1
20808,2,0,0,0,0,0,0,2
20889,0,0,0,1,0,0,0,1
20930,1,0,0,0,0,0,0,1
20931,0,0,0,1,0,0,0,1
20949,0,0,1,0,0,0,0,1
21000,1,0,0,1,0,0,0,2
21052,0,0,0,1,0,0,0,1
21053,1,0,1,0,0,0,0,2
21114,0,0,0,2,0,0,0,2
21133,1,0,0,0,0,0,0,1
21253,1,0,0,0,0,0,0,1
21297,0,0,0,1,0,0,0,1
21379,0,1,0,0,0,0,0,1
21418,0,1,0,0,0,0,0,1
21461,1,0,0,0,0,0,0,1
21542,4,0,1,0,0,0,0,5
21600,0,0,0,1,0,0,0,1
21624,0,0,0,2,0,0,0,2
21700,1,0,0,0,0,0,0,1
21760,0,0,0,1,0,0,0,1
21787,0,0,0,2,0,0,0,2
21788,0,0,0,2,0,0,0,2
21848,0,0,0,1,0,0,0,1
21868,0,0,0,1,0,0,0,1
21910,2,0,1,1,0,0,0,4
21923,0,0,1,0,0,0,0,1
22032,1,0,0,0,0,0,0,1
22080,0,1,0,0,0,0,0,1
22125,0,1,0,0,0,0,0,1
22154,1,0,0,2,0,0,0,3
22172,1,0,0,0,0,0,0,1
22194,0,0,0,1,0,0,0,1
22195,0,0,0,1,0,0,0,1
22200,0,0,1,0,0,0,0,1
22277,1,0,0,1,0,0,0,2
22306,1,0,0,0,0,0,0,1
22338,0,0,0,1,0,0,0,1
22358,1,0,1,0,0,0,0,2
22400,1,0,0,0,0,0,0,1
22465,0,0,0,1,0,0,0,1
22467,0,1,0,0,0,0,0,1
22522,1,1,0,0,0,0,0,2
22643,0,0,0,1,0,0,0,1
22644,1,0,0,1,0,0,0,2
22750,1,0,0,1,0,0,0,2
22767,0,0,0,1,0,0,0,1
22827,0,0,0,1,0,0,0,1
23011,1,0,0,1,0,0,0,2
23174,1,0,0,0,0,0,0,1
23256,1,0,1,1,0,0,0,3
23317,2,0,0,0,0,0,0,2
23338,0,0,0,1,0,0,0,1
23411,0,0,0,1,0,0,0,1
23419,0,0,0,1,0,0,0,1
23439,0,0,0,1,0,0,0,1
23440,0,0,0,1,0,0,0,1
23501,0,0,0,1,0,0,0,1
23542,0,0,0,1,0,0,0,1
23547,0,1,0,0,0,0,0,1
23562,0,0,0,1,0,0,0,1
23563,0,0,0,1,0,0,0,1
23623,0,0,0,1,0,0,0,1
23681,1,0,0,0,0,0,0,1
23684,1,0,0,0,0,0,0,1
23729,1,0,0,0,0,0,0,1
23746,1,0,0,0,0,0,0,1
23760,0,0,0,1,0,0,0,1
23800,1,0,0,1,0,0,0,2
23807,1,0,0,0,0,0,0,1
23827,1,0,0,0,0,0,0,1
23868,1,0,0,0,0,0,0,1
24072,0,0,0,1,0,0,0,1
24180,0,0,0,1,0,0,0,1
24235,0,0,1,0,0,0,0,1
24316,0,0,0,1,0,0,0,1
24358,0,0,0,1,0,0,0,1
24360,1,0,0,0,0,0,0,1
24398,1,0,0,0,0,0,0,1
24399,0,0,0,1,0,0,0,1
24480,2,0,0,0,0,0,0,2
24500,0,0,0,1,0,0,0,1
24602,0,0,0,1,0,0,0,1
24664,0,0,0,1,0,0,0,1
24725,1,0,1,0,0,0,0,2
24847,3,0,0,1,0,0,0,4
24882,0,1,0,0,0,0,0,1
24887,0,0,0,1,0,0,0,1
24900,0,0,0,1,0,0,0,1
24970,1,0,0,1,0,0,0,2
24985,0,0,0,1,0,0,0,1
25200,1,0,0,0,0,0,0,1
25214,0,1,0,0,0,0,0,1
25215,0,0,0,1,0,0,0,1
25260,0,0,0,1,0,0,0,1
25294,0,0,0,1,0,0,0,1
25296,0,0,0,1,0,0,0,1
25375,0,0,1,0,0,0,0,1
25459,1,0,0,1,0,0,0,2
25475,0,0,1,0,0,0,0,1
25582,2,0,0,1,0,0,0,3
25642,0,0,0,1,0,0,0,1
25704,0,1,0,1,0,0,0,2
25763,0,0,1,0,0,0,0,1
25833,1,0,0,0,0,0,0,1
25888,1,0,0,0,0,0,0,1
25949,0,0,1,0,0,0,0,1
26010,0,0,0,1,0,0,0,1
26030,0,1,0,0,0,0,0,1
26031,0,0,0,1,0,0,0,1
26112,0,0,0,1,0,0,0,1
26194,0,0,1,0,0,0,0,1
26438,2,0,0,0,0,0,0,2
26561,1,0,0,0,0,0,0,1
26566,1,0,0,0,0,0,0,1
26602,1,0,0,0,0,0,0,1
26683,1,0,0,1,0,0,0,2
26800,0,0,1,0,0,0,0,1
26829,1,0,0,0,0,0,0,1
26866,0,0,0,1,0,0,0,1
26928,2,0,0,0,0,0,0,2
27043,0,1,0,0,0,0,0,1
27070,1,0,0,0,0,0,0,1
27120,1,0,0,0,0,0,0,1
27262,1,0,0,0,0,0,0,1
27295,0,0,1,0,0,0,0,1
27418,1,0,1,0,0,0,0,2
27465,1,0,0,0,0,0,0,1
27541,0,0,0,1,0,0,0,1
27581,1,0,0,0,0,0,0,1
27758,0,0,1,0,0,0,0,1
27840,0,0,0,1,0,0,0,1
27907,1,0,0,0,0,0,0,1
27908,0,0,0,2,0,0,0,2
28000,1,0,0,1,0,0,0,2
28030,1,0,0,0,0,0,0,1
28050,0,0,1,0,0,0,0,1
28070,1,0,0,0,0,0,0,1
28152,0,0,1,0,0,0,0,1
28335,0,0,0,1,0,0,0,1
28356,1,0,0,0,0,0,0,1
28397,1,1,1,0,0,0,0,3
28478,1,0,0,0,0,0,0,1
28500,0,0,0,1,0,0,0,1
28519,1,0,0,0,0,0,0,1
28520,0,0,0,1,0,0,0,1
28595,1,0,0,0,0,0,0,1
28642,3,0,0,1,0,0,0,4
28664,1,0,0,0,0,0,0,1
28700,1,0,0,0,0,0,0,1
28728,0,1,0,0,0,0,0,1
28764,1,0,0,0,0,0,0,1
28886,2,0,1,1,0,0,0,4
28941,1,0,0,0,0,0,0,1
28948,0,0,0,1,0,0,0,1
28996,0,0,0,1,0,0,0,1
29008,0,0,0,1,0,0,0,1
29040,1,0,0,0,0,0,0,1
29050,0,0,0,1,0,0,0,1
29106,0,0,0,1,0,0,0,1
29131,1,0,0,0,0,0,0,1
29186,0,1,0,0,0,0,0,1
29212,0,0,0,1,0,0,0,1
29213,1,0,0,0,0,0,0,1
29376,0,0,0,1,0,0,0,1
29400,1,0,0,0,0,0,0,1
29498,1,0,0,0,0,0,0,1
29520,1,0,0,0,0,0,0,1
29539,0,0,0,1,0,0,0,1
29750,1,0,0,1,0,0,0,2
29760,1,0,0,0,0,0,0,1
29804,0,0,0,1,0,0,0,1
29865,0,0,0,1,0,0,0,1
29866,0,1,0,0,0,0,0,1
29895,0,1,0,0,0,0,0,1
29988,0,0,0,1,0,0,0,1
30100,1,0,0,2,0,0,0,3
30111,0,0,0,1,0,0,0,1
30183,1,0,0,0,0,0,0,1
30240,0,0,0,1,0,0,0,1
30431,1,0,0,0,0,0,0,1
30477,0,0,0,1,0,0,0,1
30600,0,0,0,1,0,0,0,1
30723,0,0,0,1,0,0,0,1
30800,1,0,0,0,0,0,0,1
30877,0,1,0,0,0,0,0,1
30967,0,0,1,0,0,0,0,1
31008,0,0,0,1,0,0,0,1
31082,0,0,1,0,0,0,0,1
31090,0,0,0,1,0,0,0,1
31130,1,0,0,0,0,0,0,1
31212,1,0,0,0,0,0,0,1
31320,1,0,0,0,0,0,0,1
31334,0,0,2,0,0,0,0,2
31343,0,0,0,1,0,0,0,1
31500,2,0,0,0,0,0,0,2
31620,0,0,0,1,0,0,0,1
31660,0,0,0,1,0,0,0,1
31661,0,0,1,0,0,0,0,1
31680,1,0,0,0,0,0,0,1
31824,1,0,0,0,0,0,0,1
31885,0,1,0,0,0,0,0,1
31906,0,0,0,1,0,0,0,1
31975,0,0,0,1,0,0,0,1
32069,1,0,0,1,0,0,0,2
32191,1,0,1,0,0,0,0,2
32192,0,0,0,1,0,0,0,1
32313,0,0,0,2,0,0,0,2
32395,0,0,0,1,0,0,0,1
32437,0,0,0,1,0,0,0,1
32558,1,0,0,0,0,0,0,1
32681,0,1,0,0,0,0,0,1
32803,1,0,0,0,0,0,0,1
32900,0,0,1,0,0,0,0,1
32926,0,0,0,2,0,0,0,2
32966,0,0,1,0,0,0,0,1
33000,1,0,0,0,0,0,0,1
33048,1,0,0,0,0,0,0,1
33049,0,0,0,1,0,0,0,1
33110,0,1,0,0,0,0,0,1
33293,0,1,0,0,0,0,0,1
33456,1,0,0,0,0,0,0,1
33538,1,0,0,0,0,0,0,1
33554,0,1,0,0,0,0,0,1
33600,1,0,0,0,0,0,0,1
33619,0,0,0,1,0,0,0,1
33782,4,0,0,0,0,0,0,4
33905,1,0,0,1,0,0,0,2
33966,0,0,0,1,0,0,0,1
34027,0,0,0,1,0,0,0,1
34206,0,0,0,1,0,0,0,1
34272,1,1,0,0,0,0,0,2
34300,0,0,0,1,0,0,0,1
34395,0,0,0,1,0,0,0,1
34517,0,0,0,1,0,0,0,1
34639,1,0,0,0,0,0,0,1
34650,0,0,0,1,0,0,0,1
34762,1,0,0,0,0,0,0,1
35000,0,1,0,0,0,0,0,1
35122,0,1,0,0,0,0,0,1
35128,0,0,0,1,0,0,0,1
35169,0,0,0,1,0,0,0,1
35251,0,0,0,1,0,0,0,1
35374,1,0,0,0,0,0,0,1
35435,0,0,1,0,0,0,0,1
35520,0,0,0,1,0,0,0,1
35648,0,0,0,1,0,0,0,1
35679,0,0,0,1,0,0,0,1
35863,0,0,0,1,0,0,0,1
35985,0,0,0,1,0,0,0,1
36068,0,0,0,1,0,0,0,1
36108,0,0,0,2,0,0,0,2
36125,0,0,0,1,0,0,0,1
36230,1,0,0,0,0,0,0,1
36312,2,0,0,0,0,0,0,2
36475,1,0,0,1,0,0,0,2
36480,0,0,0,1,0,0,0,1
36545,1,0,0,0,0,0,0,1
36720,1,0,0,0,0,0,0,1
36965,1,0,1,0,0,0,0,2
37100,0,0,0,1,0,0,0,1
37187,0,0,0,1,0,0,0,1
37209,0,0,0,2,0,0,0,2
37210,0,0,0,1,0,0,0,1
37699,0,0,1,0,0,0,0,1
38115,0,0,0,1,0,0,0,1
38189,0,0,1,0,0,0,0,1
38270,1,0,0,0,0,0,0,1
38434,0,0,0,1,0,0,0,1
38556,1,0,1,0,0,0,0,2
38801,1,0,0,0,0,0,0,1
38842,0,0,0,1,0,0,0,1
38964,1,0,0,0,0,0,0,1
39000,0,1,0,0,0,0,0,1
39046,1,0,0,0,0,0,0,1
39168,1,0,0,0,0,0,0,1
39250,1,0,0,0,0,0,0,1
39290,0,0,0,1,0,0,0,1
39360,0,0,0,1,0,0,0,1
39535,0,1,0,0,0,0,0,1
39660,0,0,0,1,0,0,0,1
39779,0,0,1,0,0,0,0,1
39780,0,0,0,1,0,0,0,1
39840,0,0,0,1,0,0,0,1
39984,0,0,0,1,0,0,0,1
40147,0,0,0,1,0,0,0,1
40229,0,0,1,0,0,0,0,1
40250,1,0,1,0,0,0,0,2
40269,0,0,0,1,0,0,0,1
40331,0,0,0,1,0,0,0,1
40392,0,0,0,1,0,0,0,1
40500,0,0,0,1,0,0,0,1
40514,1,0,0,0,0,0,0,1
40759,2,0,0,0,0,0,0,2
40882,0,0,0,1,0,0,0,1
40950,1,0,0,0,0,0,0,1
41045,0,0,0,1,0,0,0,1
41127,0,0,0,1,0,0,0,1
41208,1,0,0,0,0,0,0,1
41371,2,0,0,0,0,0,0,2
41494,1,0,0,0,0,0,0,1
41738,0,0,0,2,0,0,0,2
41861,1,0,0,0,0,0,0,1
41880,1,0,0,0,0,0,0,1
41983,0,1,0,0,0,0,0,1
42000,0,0,0,1,0,0,0,1
42106,1,0,0,0,0,0,0,1
42350,0,0,0,1,0,0,0,1
42596,0,0,0,1,0,0,0,1
42775,0,0,1,0,0,0,0,1
42780,0,0,0,1,0,0,0,1
42962,1,0,0,0,0,0,0,1
42991,1,0,0,0,0,0,0,1
43050,1,0,0,1,0,0,0,2
43146,1,0,1,0,0,0,0,2
43248,0,0,1,0,0,0,0,1
43330,0,0,1,0,0,0,0,1
43440,0,0,0,1,0,0,0,1
43460,1,0,0,0,0,0,0,1
43750,0,0,0,2,0,0,0,2
43777,1,0,0,0,0,0,0,1
43819,1,0,0,0,0,0,0,1
44038,1,0,0,0,0,0,0,1
44140,0,0,0,1,0,0,0,1
44248,0,0,0,1,0,0,0,1
44309,1,0,1,2,0,0,0,4
44370,0,1,0,0,0,0,0,1
44371,0,0,0,1,0,0,0,1
44473,0,0,0,1,0,0,0,1
44677,0,0,0,1,0,0,0,1
44715,0,0,0,1,0,0,0,1
44798,0,0,0,1,0,0,0,1
44799,0,0,0,1,0,0,0,1
44859,0,0,0,1,0,0,0,1
45043,0,0,0,1,0,0,0,1
45059,0,0,0,1,0,0,0,1
45120,0,0,0,1,0,0,0,1
45166,0,0,1,1,0,0,0,2
45395,0,0,1,0,0,0,0,1
45452,0,0,0,1,0,0,0,1
45500,0,0,0,1,0,0,0,1
45521,0,1,0,0,0,0,0,1
45860,0,0,0,1,0,0,0,1
46023,0,0,0,2,0,0,0,2
46186,0,1,0,0,0,0,0,1
46308,0,0,1,0,0,0,0,1
46675,0,0,0,1,0,0,0,1
46680,0,0,0,1,0,0,0,1
47165,0,1,0,0,0,0,0,1
47250,1,0,0,0,0,0,0,1
47404,0,0,0,1,0,0,0,1
47491,1,1,0,0,0,0,0,2
47532,1,0,0,0,0,0,0,1
47576,0,0,0,1,0,0,0,1
47600,0,0,1,1,0,0,0,2
47736,0,0,0,1,0,0,0,1
47981,1,0,0,0,0,0,0,1
48104,0,0,0,1,0,0,0,1
48480,1,0,0,0,0,0,0,1
48512,0,1,0,0,0,0,0,1
48595,1,0,0,0,0,0,0,1
48715,0,0,0,1,0,0,0,1
49123,0,0,0,1,0,0,0,1
49368,1,0,0,0,0,0,0,1
49572,0,0,0,1,0,0,0,1
49875,1,0,0,0,0,0,0,1
49939,0,0,1,0,0,0,0,1
49940,0,0,0,1,0,0,0,1
50184,1,0,0,0,0,0,0,1
50429,1,0,0,0,0,0,0,1
50551,0,0,0,1,0,0,0,1
50592,0,0,0,1,0,0,0,1
50693,0,0,0,0,0,0,1,1
50754,0,0,0,1,0,0,0,1
51120,1,0,0,0,0,0,0,1
51163,0,0,0,1,0,0,0,1
51228,0,0,0,0,0,0,1,1
51280,0,0,0,1,0,0,0,1
51286,1,0,0,0,0,0,0,1
51530,0,0,0,1,0,0,0,1
51653,0,0,0,1,0,0,0,1
52143,0,0,0,1,0,0,0,1
52511,0,0,0,1,0,0,0,1
52552,0,0,0,1,0,0,0,1
52636,0,0,0,1,0,0,0,1
53183,0,0,0,1,0,0,0,1
53200,0,0,0,1,0,0,0,1
53244,1,0,0,0,0,0,0,1
53867,0,0,0,1,0,0,0,1
54101,1,0,0,0,0,0,0,1
54250,0,1,0,0,0,0,0,1
54358,0,0,0,1,0,0,0,1
54468,1,0,0,0,0,0,0,1
54589,0,0,0,1,0,0,0,1
54590,0,1,0,0,0,0,0,1
54591,0,0,0,1,0,0,0,1
54958,0,0,0,1,0,0,0,1
55125,1,0,0,0,0,0,0,1
55162,1,0,0,1,0,0,0,2
55300,0,0,0,1,0,0,0,1
55800,0,0,0,1,0,0,0,1
56304,1,0,0,0,0,0,0,1
56426,1,1,0,0,0,0,0,2
56712,1,0,0,0,0,0,0,1
56754,0,0,0,1,0,0,0,1
57038,1,0,1,0,0,0,0,2
57120,0,0,0,1,0,0,0,1
57283,0,0,0,1,0,0,0,1
57527,0,0,0,1,0,0,0,1
57819,0,0,0,1,0,0,0,1
58262,0,0,1,0,0,0,0,1
58344,0,0,0,1,0,0,0,1
58521,0,0,0,1,0,0,0,1
58874,0,1,0,0,0,0,0,1
59486,0,0,0,1,0,0,0,1
59500,0,0,0,1,0,0,0,1
60110,0,0,0,1,0,0,0,1
60254,0,0,0,1,0,0,0,1
60710,0,0,0,1,0,0,0,1
60711,0,0,0,1,0,0,0,1
60833,1,0,0,0,0,0,0,1
61445,1,0,0,0,0,0,0,1
61502,0,1,0,0,0,0,0,1
61608,0,0,0,1,0,0,0,1
61690,0,0,1,1,0,0,0,2
61965,0,0,0,1,0,0,0,1
62040,0,0,0,1,0,0,0,1
62292,1,0,0,0,0,0,0,1
62302,1,0,0,0,0,0,0,1
62424,1,0,0,0,0,0,0,1
62597,0,0,0,1,0,0,0,1
62873,0,0,0,1,0,0,0,1
63159,0,0,0,1,0,0,0,1
63893,1,0,0,0,0,0,0,1
64056,0,1,0,0,0,0,0,1
64219,0,1,0,0,0,0,0,1
64464,1,0,0,0,0,0,0,1
64750,1,0,0,0,0,0,0,1
65117,0,0,1,0,0,0,0,1
65606,0,0,0,1,0,0,0,1
66500,0,0,0,1,0,0,0,1
66708,0,0,0,1,0,0,0,1
66953,0,1,0,0,0,0,0,1
67321,0,0,0,1,0,0,0,1
67524,0,0,1,0,0,0,0,1
67550,0,0,0,1,0,0,0,1
67565,0,0,0,1,0,0,0,1
67810,1,0,0,0,0,0,0,1
68250,0,0,0,1,0,0,0,1
68544,1,0,0,0,0,0,0,1
69278,0,1,0,0,0,0,0,1
70036,0,0,0,1,0,0,0,1
70135,0,0,1,0,0,0,0,1
70584,1,0,0,0,0,0,0,1
70810,0,0,0,1,0,0,0,1
70875,0,0,0,1,0,0,0,1
71033,0,1,0,0,0,0,0,1
71604,0,1,0,0,0,0,0,1
72202,0,0,0,1,0,0,0,1
72502,0,0,0,1,0,0,0,1
72706,1,0,0,0,0,0,0,1
72950,1,0,0,1,0,0,0,2
73440,0,0,1,0,0,0,0,1
73930,0,0,0,1,0,0,0,1
73990,0,0,0,1,0,0,0,1
74174,0,1,0,0,0,0,0,1
74305,0,0,0,1,0,0,0,1
75250,2,0,0,0,0,0,0,2
75892,0,0,0,1,0,0,0,1
76704,0,0,0,1,0,0,0,1
77194,1,0,0,0,0,0,0,1
77700,0,0,0,1,0,0,0,1
77845,0,0,0,1,0,0,0,1
78000,0,0,0,1,0,0,0,1
78050,0,1,0,0,0,0,0,1
78750,0,0,0,1,0,0,0,1
78947,0,0,0,1,0,0,0,1
79070,0,0,0,1,0,0,0,1
79887,0,0,0,1,0,0,0,1
80415,0,0,0,1,0,0,0,1
81437,1,0,0,0,0,0,0,1
82009,0,0,0,1,0,0,0,1
82135,0,0,0,1,0,0,0,1
82250,0,0,0,1,0,0,0,1
82600,0,0,0,1,0,0,0,1
83170,0,0,0,1,0,0,0,1
83967,0,0,0,1,0,0,0,1
84000,0,0,0,1,0,0,0,1
84701,0,0,0,1,0,0,0,1
84864,0,1,0,0,0,0,0,1
85027,0,0,0,1,0,0,0,1
85313,1,0,0,0,0,0,0,1
85750,1,0,0,0,0,0,0,1
86047,0,0,0,1,0,0,0,1
86755,0,0,0,1,0,0,0,1
87067,0,0,0,1,0,0,0,1
87149,0,0,0,1,0,0,0,1
87497,0,0,0,1,0,0,0,1
88129,0,0,0,1,0,0,0,1
88200,0,0,0,1,0,0,0,1
89250,0,0,0,1,0,0,0,1
89353,0,0,0,1,0,0,0,1
90327,1,0,0,0,0,0,0,1
90530,0,0,0,1,0,0,0,1
91065,0,0,0,1,0,0,0,1
91392,1,0,0,0,0,0,0,1
91719,0,0,0,1,0,0,0,1
92045,0,0,0,1,0,0,0,1
94500,0,0,0,2,0,0,0,2
94657,0,0,0,1,0,0,0,1
94930,0,0,0,1,0,0,0,1
94982,0,0,0,1,0,0,0,1
95064,0,0,0,1,0,0,0,1
95375,0,0,0,1,0,0,0,1
96329,0,0,1,0,0,0,0,1
97516,0,0,0,1,0,0,0,1
97757,0,1,0,0,0,0,0,1
98000,1,0,0,0,0,0,0,1
98420,0,0,0,1,0,0,0,1
98573,1,0,0,1,0,0,0,2
98700,0,0,0,1,0,0,0,1
98777,0,0,0,1,0,0,0,1
98987,0,0,0,1,0,0,0,1
99119,0,0,0,1,0,0,0,1
99461,1,0,0,0,0,0,0,1
100585,0,0,0,1,0,0,0,1
101102,1,0,0,0,0,0,0,1
101847,0,0,0,1,0,0,0,1
103795,0,0,0,1,0,0,0,1
105509,0,0,0,1,0,0,0,1
105971,0,0,0,1,0,0,0,1
107060,0,0,0,1,0,0,0,1
108202,0,0,1,0,0,0,0,1
110160,0,0,1,0,0,0,0,1
110250,1,0,0,0,0,0,0,1
110475,0,0,0,1,0,0,0,1
111315,0,0,0,1,0,0,0,1
112700,0,0,2,0,0,0,0,2
113098,0,1,0,0,0,0,0,1
113751,0,0,0,1,0,0,0,1
113985,0,0,0,1,0,0,0,1
114076,0,0,0,1,0,0,0,1
114100,0,0,0,1,0,0,0,1
114321,0,0,0,1,0,0,0,1
114648,0,0,0,1,0,0,0,1
114802,0,0,0,1,0,0,0,1
116900,0,0,1,0,0,0,0,1
117250,0,0,2,0,0,0,0,2
117490,0,0,0,1,0,0,0,1
118560,0,0,0,1,0,0,0,1
119057,0,0,0,1,0,0,0,1
119462,1,0,0,0,0,0,0,1
120004,0,0,0,1,0,0,0,1
121176,0,0,0,1,0,0,0,1
122808,0,0,0,1,0,0,0,1
123216,1,0,0,0,0,0,0,1
124021,0,0,0,1,0,0,0,1
124250,0,0,2,0,0,0,0,2
124636,0,0,0,1,0,0,0,1
125090,0,0,1,0,0,0,0,1
125338,0,0,0,1,0,0,0,1
126000,0,0,0,1,0,0,0,1
126228,0,0,0,1,0,0,0,1
130625,0,0,0,1,0,0,0,1
130876,0,0,0,1,0,0,0,1
131250,0,0,0,1,0,0,0,1
132246,0,0,0,1,0,0,0,1
132863,0,0,0,1,0,0,0,1
133640,0,0,1,0,0,0,0,1
133700,0,0,0,1,0,0,0,1
135865,0,0,0,1,0,0,0,1
136971,0,0,0,1,0,0,0,1
137333,0,1,0,0,0,0,0,1
137577,0,0,0,1,0,0,0,1
138250,0,0,0,1,0,0,0,1
140026,0,1,0,0,0,0,0,1
140637,0,0,0,1,0,0,0,1
142719,0,0,0,1,0,0,0,1
142858,0,0,1,0,0,0,0,1
143575,1,0,0,0,0,0,0,1
143847,0,0,0,1,0,0,0,1
145250,0,0,0,1,0,0,0,1
146146,0,0,0,1,0,0,0,1
147696,0,0,0,1,0,0,0,1
150129,0,0,0,1,0,0,0,1
152231,0,0,0,1,0,0,0,1
154731,0,0,0,1,0,0,0,1
154821,0,0,0,1,0,0,0,1
155693,0,0,0,1,0,0,0,1
155750,0,0,0,1,0,0,0,1
156048,0,0,0,1,0,0,0,1
157068,1,0,0,0,0,0,0,1
157896,1,0,0,0,0,0,0,1
161416,0,0,0,1,0,0,0,1
161812,0,0,0,1,0,0,0,1
161875,0,0,0,1,0,0,0,1
161976,0,0,0,1,0,0,0,1
162344,0,0,0,1,0,0,0,1
162548,0,0,0,1,0,0,0,1
162839,0,0,0,1,0,0,0,1
163526,0,0,1,0,0,0,0,1
164345,0,0,0,1,0,0,0,1
166217,0,0,0,1,0,0,0,1
167299,0,0,0,1,0,0,0,1
169728,0,0,0,1,0,0,0,1
171639,0,1,0,0,0,0,0,1
172380,0,0,0,1,0,0,0,1
173250,0,0,0,1,0,0,0,1
173654,0,0,0,2,0,0,0,2
175000,0,0,0,1,0,0,0,1
175032,0,0,0,1,0,0,0,1
175276,0,0,0,1,0,0,0,1
176099,0,0,0,1,0,0,0,1
178400,0,0,0,1,0,0,0,1
179031,0,0,0,1,0,0,0,1
182827,0,0,0,1,0,0,0,1
187484,0,0,0,1,0,0,0,1
190023,0,0,0,1,0,0,0,1
190750,0,0,0,1,0,0,0,1
194616,0,0,0,1,0,0,0,1
196574,0,0,0,1,0,0,0,1
197750,0,0,0,1,0,0,0,1
197913,0,0,0,1,0,0,0,1
197916,0,0,0,1,0,0,0,1
202393,0,0,0,1,0,0,0,1
203270,1,0,0,0,0,0,0,1
206500,0,1,0,0,0,0,0,1
209793,0,0,0,1,0,0,0,1
212173,0,0,0,1,0,0,0,1
215016,0,1,0,0,0,0,0,1
215443,0,0,0,1,0,0,0,1
216113,0,0,0,1,0,0,0,1
217000,0,0,0,1,0,0,0,1
223257,0,0,0,1,0,0,0,1
224045,0,0,0,1,0,0,0,1
224483,0,0,0,1,0,0,0,1
226644,0,0,0,1,0,0,0,1
239888,0,0,0,1,0,0,0,1
242745,0,0,0,1,0,0,0,1
245000,0,0,0,1,0,0,0,1
246970,0,0,0,1,0,0,0,1
247452,0,0,0,1,0,0,0,1
254400,0,0,0,1,0,0,0,1
265409,0,0,0,1,0,0,0,1
276555,0,0,0,1,0,0,0,1
281519,0,0,0,1,0,0,0,1
285250,0,0,0,1,0,0,0,1
295750,0,0,0,1,0,0,0,1
301792,0,0,0,1,0,0,0,1
309736,0,0,0,1,0,0,0,1
319506,0,0,0,1,0,0,0,1
322716,0,0,0,1,0,0,0,1
323940,0,0,0,1,0,0,0,1
324450,0,0,0,1,0,0,0,1
324835,0,0,0,1,0,0,0,1
327655,0,0,0,1,0,0,0,1
327787,0,1,0,0,0,0,0,1
339500,0,0,0,1,0,0,0,1
341250,0,0,0,1,0,0,0,1
341379,0,0,0,1,0,0,0,1
345800,0,0,0,1,0,0,0,1
346500,0,0,0,1,0,0,0,1
359536,0,0,0,1,0,0,0,1
364720,0,0,0,1,0,0,0,1
375942,0,0,0,1,0,0,0,1
380372,0,0,0,0,0,0,1,1
380848,0,0,0,1,0,0,0,1
389522,0,0,0,1,0,0,0,1
402393,0,0,0,1,0,0,0,1
404185,0,0,0,1,0,0,0,1
434112,0,0,0,1,0,0,0,1
435381,0,0,0,1,0,0,0,1
437308,0,0,0,1,0,0,0,1
443908,0,0,0,1,0,0,0,1
449694,0,0,0,1,0,0,0,1
449702,0,1,0,0,0,0,0,1
453003,0,0,0,1,0,0,0,1
454226,0,0,0,1,0,0,0,1
456145,0,0,0,1,0,0,0,1
460250,0,0,0,1,0,0,0,1
463066,0,0,0,1,0,0,0,1
469874,0,0,0,1,0,0,0,1
488269,0,0,0,1,0,0,0,1
493421,0,0,0,1,0,0,0,1
513935,0,0,0,1,0,0,0,1
525715,0,0,0,1,0,0,0,1
529677,0,0,0,1,0,0,0,1
533627,0,0,0,1,0,0,0,1
539955,0,0,0,1,0,0,0,1
540328,0,0,0,1,0,0,0,1
559621,0,0,0,1,0,0,0,1
566951,0,0,0,1,0,0,0,1
575588,0,0,0,1,0,0,0,1
583277,0,0,0,1,0,0,0,1
592924,0,0,0,1,0,0,0,1
605467,0,0,0,1,0,0,0,1
634881,0,0,0,1,0,0,0,1
659233,0,0,0,1,0,0,0,1
687611,0,0,0,1,0,0,0,1
689478,0,0,0,1,0,0,0,1
713556,0,0,0,1,0,0,0,1
716929,0,0,0,1,0,0,0,1
750146,0,0,0,1,0,0,0,1
769806,0,0,0,1,0,0,0,1
770410,0,0,0,1,0,0,0,1
780207,0,0,0,1,0,0,0,1
783380,0,0,0,1,0,0,0,1
810661,0,0,0,1,0,0,0,1
837784,0,0,0,1,0,0,0,1
845688,0,0,0,1,0,0,0,1
850586,0,0,0,1,0,0,0,1
859349,0,0,0,1,0,0,0,1
874340,0,0,0,1,0,0,0,1
905867,0,0,0,1,0,0,0,1
928834,0,0,0,1,0,0,0,1
1003664,0,0,0,1,0,0,0,1
1044343,0,0,0,1,0,0,0,1
1138390,0,0,0,1,0,0,0,1
1149933,0,0,0,1,0,0,0,1
1202351,0,0,0,1,0,0,0,1
1255573,0,0,0,1,0,0,0,1
1256592,0,0,0,0,0,0,1,1
1287110,0,0,0,1,0,0,0,1
1299841,0,0,0,1,0,0,0,1
1307622,0,0,0,1,0,0,0,1
1673112,0,0,0,1,0,0,0,1
1944654,0,1,0,0,0,0,0,1
2019266,1,0,0,0,0,0,0,1
2023937,0,0,0,1,0,0,0,1
2069557,0,0,0,1,0,0,0,1
2087644,0,0,0,1,0,0,0,1
2200050,0,1,0,0,0,0,0,1
3405385,0,0,0,1,0,0,0,1
3586010,0,0,0,0,0,0,1,1
3747451,0,0,0,1,0,0,0,1
4853364,0,0,0,0,0,0,1,1
5747801,0,0,0,0,1,0,0,1
5929983,0,0,0,0,0,0,1,1